Sentence	Label	Comparative	Comment
OBJECT_A, and OBJECT_B, too) undoubtedly influenced people's votes when it	NO_COMP	False	
I'd go with OBJECT_A or OBJECT_B.	NO_COMP	False	
This is potentially useful for OBJECT_A, PHP, JS and OBJECT_B.	NO_COMP	False	
And your other server languages like OBJECT_A, PHP, OBJECT_B, etc.	NO_COMP	False	
Java learned a lot from OBJECT_A, OBJECT_B and even C#.	NO_COMP	False	
OBJECT_A/OBJECT_B/Groovy/Perl is:	NO_COMP	False	
Java, OBJECT_A, OBJECT_B, Perl, also all work.	NO_COMP	False	
highlighting mzscheme, perl, OBJECT_A, and OBJECT_B by default.	NO_COMP	False	
Highly skilled in Perl, PHP, OBJECT_A, OBJECT_B programming languages.	NO_COMP	False	
OBJECT_A, java, OBJECT_B, php, javascript	NO_COMP	False	
So it comes down to OBJECT_A and OBJECT_B.	NO_COMP	False	
OBJECT_A, OBJECT_B Compiled languages - e.g.	NO_COMP	False	
However, there is OBJECT_A and OBJECT_B Rails to consider.	NO_COMP	False	
Perl, OBJECT_A, OBJECT_B, and Unix shell scripts are also used.	NO_COMP	False	
Possibly OBJECT_A or OBJECT_B.	NO_COMP	False	
Groovy, Perl, OBJECT_A, OBJECT_B, Bash).	NO_COMP	False	
Speed: similar to Perl, OBJECT_A, OBJECT_B.	NO_COMP	False	
Drop it immediately and start learning PHP, OBJECT_A, or OBJECT_B.	NO_COMP	False	
language such as JavaScript, OBJECT_A, OBJECT_B, Groovy, etc.).	NO_COMP	False	
PHP, OBJECT_A, or OBJECT_B?	NO_COMP	False	
I prefer OBJECT_A over OBJECT_B on windows.	BETTER	True	
Perl, OBJECT_A, PHP, OBJECT_B), forking isn't a problem.	NO_COMP	False	
Perl, OBJECT_A, OBJECT_B and C# are good ones.	NO_COMP	False	
I have a extrange problem compiling OBJECT_A/OBJECT_B extension.	NO_COMP	False	
Scripting- OBJECT_A, OBJECT_B, Perl, PowerShell.	NO_COMP	False	
While OBJECT_A is slightly faster, OBJECT_B utilises memory better.	UNCLEAR	True	
A OBJECT_A/OBJECT_B script might work better for this....	NO_COMP	False	
That's because a lot of those applications may not even be written in D or have anything to do with D, like the mass of stuff written in dynamic languages like perl, OBJECT_A, OBJECT_B, etc.	NO_COMP	False	
The script uses SQLite3 as a backend, because bash is not good with arrays, and because I'm not good with Perl/OBJECT_A/OBJECT_B.	NO_COMP	False	
Immutability fits into this complex because in OBJECT_A/Perl/OBJECT_B/other languages I often solve this with some form of monkeypatching, which is a form of mutability.	NO_COMP	False	
There are much better alternatives (OBJECT_A, OBJECT_B).	NO_COMP	False	
Your C# and VB devs can suddenly easily write web apps and your OBJECT_A and OBJECT_B devs can too - with the added bonus of much better performance.	NO_COMP	False	
Maybe we should stop using languages like OBJECT_A, OBJECT_B and Perl because they're "slow".	NO_COMP	False	
He raises the point that runtime libraries for OBJECT_A / OBJECT_B etc have a unique set of issues because they tend to have their own packaging systems.	NO_COMP	False	
But maybe that's just because I'm not used to seeing OBJECT_A, just as you're not used to seeing OBJECT_B code.	NO_COMP	False	
I guess that's fair because the implementation might be done better in OBJECT_A than it was in OBJECT_B.	BETTER	True	
I'm not totally convinced the debugging tools for Perl, OBJECT_A or PHP are substantially better than OBJECT_B, even if they are slightly better.	BETTER	True	
Agile development is the most popular model at the moment because of architectures like OBJECT_A on Rails and Django (for OBJECT_B).	NO_COMP	False	
In addition the comparison on multi-core machines is also flawed because OBJECT_A code uses only one CPU whereas OBJECT_B uses all four due to use of multiprocessing library.	WORSE	True	one need some knowledge here; NO_COMP might be okay
OBJECT_A is even worse than OBJECT_B.	WORSE	True	
Perl, OBJECT_A, and OBJECT_B were successful because their creators were good coders with clear goals, who shipped useful programs.	NO_COMP	False	
OBJECT_A and OBJECT_B were much more recently the "hot new thing" and have gotten a lot more attention in the last decade or so because of that.	NO_COMP	False	
I've tried OBJECT_A, and can see why people like it, but OBJECT_B suits my style better.	WORSE	True	
OBJECT_A and OBJECT_B are languages competing for a similar bracket, so they will always appear to be "converging," because smart people are finding the key features.	NO_COMP	False	
I started with OO languages (OBJECT_A & OBJECT_B) because people recommend them, and they seem to be relatively easy to get started with.	NO_COMP	False	
Unfortunately, when it comes to potential projects OBJECT_A suffers because it's similarity to OBJECT_B.	NO_COMP	False	
It is worth noting that because the APIs use the standard HTTP protocol you can easily work with them from any programming language including C#, Java, OBJECT_A, OBJECT_B, Perl, PHP and others.	NO_COMP	False	
With dynamically typed languages, like PHP, OBJECT_A, OBJECT_B, your development will be much faster, but you will have to test your code much better.	NO_COMP	False	
The only reason OBJECT_A is used over OBJECT_B, is because of libraries...	BETTER	True	
And now that MS has support for OBJECT_A and OBJECT_B, they are as evil as before but also stupid, because that means they don't have any direction to give to the community.	NO_COMP	False	
a sequence reserve can be simply: s.reverse etc. if you use databases: OBJECT_A database binding API is arguably better than OBJECT_B.	BETTER	True	
It comes with an updated XML stack and lets dynamic languages like OBJECT_A, Groovy, OBJECT_B and JavaScript get better performance running on JVMs.	NO_COMP	False	
We will just be a little more conscious," because I don't see OBJECT_A or OBJECT_B as being inevitably slower.	NO_COMP	False	
The problem is OBJECT_A and OBJECT_B are not seen as enterprise ready or fit for anything better than simple applications.	NO_COMP	False	
OBJECT_A and OBJECT_B perform significantly better.	NO_COMP	False	
Yes, I keep on bitchin' on collectors because I should probably spend my free time learning OBJECT_A or OBJECT_B or something.	NO_COMP	False	
The even better news is that it is actually possible to use a variety of tools: OBJECT_A, OBJECT_B, shell scripts and R to perform distributed fault tolerant processing of your data on a Hadoop cluster....	NO_COMP	False	
That hurts because for a company to want a telecommuter bad enough, they'd better bring some serious talent to the table which usually consists of front-end, backend, OBJECT_A and OBJECT_B experience.	NO_COMP	False	
So in OBJECT_A, a good programmer will want to take a different route to solving the problem than he would in OBJECT_B, just because it actually is the better way to do it.	NO_COMP	False	
He also thinks that "SOAP never caught on because many popular languages were left out such as OBJECT_A and OBJECT_B."	NO_COMP	False	
I mention all that because I think you've missed an important way in which OBJECT_A blocks are more powerful than anything in OBJECT_B: a block executes fully within the defining context.	BETTER	True	
For better or worse, OBJECT_A, OBJECT_B, JavaScript and so on have changed how people see programming.	NO_COMP	False	
People fight over principles like "OBJECT_A is better than OBJECT_B" or "you shouldn't write unit test," all of which are absolutely absurd.	NO_COMP	False	tricky one
Node is a good fit for CouchDB because Couch encourages asynchronous background processes, but people also use OBJECT_A / OBJECT_B / Java for the same purposes.	NO_COMP	False	
It is a lot easier to do text parsing in Perl/OBJECT_A/OBJECT_B than it is in Java or C# (partially because it is a lot easier to use regular expressions).	UNCLEAR	True	
Wanting to learn more about Google Wave, I ported the Wave Robot OBJECT_A Client library to OBJECT_B, mainly because I wanted to understand the protocol.	NO_COMP	False	
for json: i also think its better to just use OBJECT_A, OBJECT_B, perl and transform it.	NO_COMP	False	
Sitting down with another programming language for a while can open your mind up to other ways of solving problems, and I think I became a better OBJECT_A programmer after spending time in OBJECT_B land.	NO_COMP	False	
I think this is very accurate because I see most people that complain against PHP, they are usually somebody that has an agenda to favor some other language... can be OBJECT_A or OBJECT_B.	NO_COMP	False	
OBJECT_A is like perl and OBJECT_B, only better, and it is required to run this software.	NO_COMP	False	
OBJECT_A and OBJECT_B are even worse than Java performance wise.	UNCLEAR	True	
I wonder if they didn't compare themselves to OBJECT_A or OBJECT_B because they couldn't contrive examples that produce huge LOC differences?	NO_COMP	False	
For this reason alone, OBJECT_A is clearly better than OBJECT_B or Perl.	BETTER	True	
Anyway, for this book, geany has been used, mainly because it handles both OBJECT_A and OBJECT_B (amongst many others), and is rather lightweight.	NO_COMP	False	
I love the language but I'm considering getting better at OBJECT_A just because OBJECT_B is so slow I feel bad using it for anything serious.	BETTER	True	
Modern languages like scala, OBJECT_A and maybe OBJECT_B are much better at this.	NO_COMP	False	
I usually recommend OBJECT_A over OBJECT_B, as I prefer it, but in this case it may be better, due to everything inherently being an object.	WORSE	True	
It's why I mention OBJECT_A and OBJECT_B, because they've at least heard of them.	NO_COMP	False	
And so you have many programmers choosing to use OBJECT_A or OBJECT_B because good libraries exist there for solving modern problems.	NO_COMP	False	
OBJECT_A or OBJECT_B may actually help promote better programming practices, but they aren't as accessible as PHP in terms of examples, online docs and tutorials, and hosting is not as easy.	UNCLEAR	True	
OBJECT_A would have also been a good choice but IMO it is an inferior language compared to OBJECT_B.	WORSE	True	
Got a good job writing C++? Hopefully you also know some Java, or better yet some OBJECT_A, OBJECT_B or some other higher level scripting language.	NO_COMP	False	
I'd been kind of hoping Apple would dump AppleScript and switch over to OBJECT_A or (even better) OBJECT_B as the official AppleEvent scripting language [1].	WORSE	True	tricky one
I'd go so far as to say OBJECT_A and OBJECT_B aren't either, though both are very powerful and are better suited to some tasks than Java.	NO_COMP	False	
Proves Superior to OBJECT_A, OBJECT_B, Perl and Other Dynamic Programming Languages	NO_COMP	False	
I'm a huge OBJECT_A/Django & OBJECT_B/Rails fan, but I will never stop using PHP because it is so broadly accepted and supported.	NO_COMP	False	
OBJECT_A and OBJECT_B support features of orthogonality, maintainability, etc. even better, in many respects.	NO_COMP	False	
Your argument of awk being the "underlanguage" and not suitable for the job because you think that only Perl/OBJECT_A/OBJECT_B can do the job is flawed and weak.	UNCLEAR	True	
OBJECT_A has RDoc , and it looks better than anything I've seen in OBJECT_B.	BETTER	True	
You might be better served learning a language like Objective-C, OBJECT_A, OBJECT_B or even Unix shell-scripting, which are more useful for creating useful code on modern computer systems.	NO_COMP	False	
Any sources that discuss the pros and cons of each or why it would be better to do X in OBJECT_A rather than OBJECT_B?	UNCLEAR	True	
Perl isn't dying because the competition, namely OBJECT_A and OBJECT_B, is itself idiosyncratic, Hyperlogos blogger Martin Espinoza opined.	NO_COMP	False	
Today? You'll build a better app in less time and with fewer people using OBJECT_A with Django or OBJECT_B on Rails.	NO_COMP	False	
One of them ( Jan rather than Andrzej ) was of the opinion that OBJECT_A was more object oriented than OBJECT_B because you are able tack methods onto the built-in classes.	BETTER	True	
OBJECT_A, OBJECT_B, WordPress, and the old standard OpenOffice (in a freshly minted version 4) are better and stronger than ever.	NO_COMP	False	
OBJECT_A has better support for such declarative styles and I am glad the core OBJECT_B language is not going down that route.	BETTER	True	
Mainly because OBJECT_A is used in considerably more non-web applications than OBJECT_B, which makes your skills more portable (and you more employable).	BETTER	True	
This is one area where MySQL Cookbook really shines, because it contains a large amount of sample code in Perl, PHP, OBJECT_A, Java, and even OBJECT_B.	NO_COMP	False	
I use OBJECT_A and OBJECT_B heavily because it's easy for other people to understand and I can quickly do a task in them.	NO_COMP	False	
I take your word that Perl/OBJECT_A/OBJECT_B/LISP/whatever is much superior.	NO_COMP	False	
OBJECT_A and OBJECT_B only.	NO_COMP	False	
OBJECT_A, iPad, and OBJECT_B Compatible!	NO_COMP	False	
(See OBJECT_A Dethrones the OBJECT_B .)	BETTER	True	
OBJECT_A, OBJECT_B, BlackBerry, Windows	NO_COMP	False	
, free for OBJECT_A and OBJECT_B).	NO_COMP	False	
Download our OBJECT_A & OBJECT_B Apps	NO_COMP	False	
OBJECT_A/iPad and OBJECT_B Apps	NO_COMP	False	
...developer for OBJECT_A AND OBJECT_B.	NO_COMP	False	
(OBJECT_A, OBJECT_B).	NO_COMP	False	
Apps for OBJECT_A and OBJECT_B	NO_COMP	False	
(OBJECT_A, OBJECT_B; free)	NO_COMP	False	
( OBJECT_A , OBJECT_B , Metal Slug X )	NO_COMP	False	
OBJECT_A, OBJECT_B & web app developer	NO_COMP	False	
OBJECT_A and OBJECT_B editions (£2.39),	NO_COMP	False	
OBJECT_A and OBJECT_B apps	NO_COMP	False	
OBJECT_A  and  OBJECT_B .	NO_COMP	False	
OBJECT_A & OBJECT_B Development	NO_COMP	False	
OBJECT_A, OBJECT_B, Windows phone, etc).	NO_COMP	False	
RetailMeNot for OBJECT_A or OBJECT_B .	NO_COMP	False	
OBJECT_A], OBJECT_B, Windows and Linux)	NO_COMP	False	
( OBJECT_A , Crush , iPad , OBJECT_B )	NO_COMP	False	
OBJECT_A and OBJECT_B app.	NO_COMP	False	
OBJECT_A, iPad & OBJECT_B Devices Supported	NO_COMP	False	
Flowd (OBJECT_A/OBJECT_B/Nokia)	NO_COMP	False	
OBJECT_A / BlackBerry / OBJECT_B / Symbian	NO_COMP	False	
OBJECT_A is much better, economically speaking, than OBJECT_B.	BETTER	True	
Probably because of this they would find OBJECT_A more simple and straightforward than OBJECT_B.	BETTER	True	
If you're a fed-up OBJECT_A user looking to switch to an OBJECT_B device, there are better options.	NO_COMP	False	
I'm actually quite disappointed with how much better are the photos than from my OBJECT_A, which easily matched OBJECT_B 4S.	BETTER	True	
why accept an inferior phone running Google's OBJECT_A when you can have Apple's superior OBJECT_B for a hundred dollars more? That is a matter of opinion.	WORSE	True	
It multitasks even better than OBJECT_A, its as responsive as an OBJECT_B, and its hardware is better than most blackberries.	NO_COMP	False	
People do not necessarily switch from an OBJECT_A to an OBJECT_B or vice versa because they think one is better than the other.	NO_COMP	False	
This is significant if you consider there are a number of OBJECT_A phones available for a similar price which are technologically superior to the OBJECT_B 3GS .	BETTER	True	
How hard is it to accept the fact OBJECT_A is doing better then the OBJECT_B these days?	BETTER	True	
However, with Apple's switch, Google's superior mapping app gives OBJECT_A phones a clear advantage over the OBJECT_B in this important function.	BETTER	True	
There was no port to OBJECT_A, iPad, or OBJECT_B because that would require rewriting the program.	NO_COMP	False	
(Seriously this page works worse on an OBJECT_A using chrome than it did on the OBJECT_B using safari.)	WORSE	True	
Unsure if the ole OBJECT_A has this app, because OBJECT_B is so much better..lol..but the SLEEP APNEA 2.0 SLEEP ANALYZER works great.	WORSE	True	
See what OBJECT_A or OBJECT_B has to offer " better smartphones than BlackBerries!	NO_COMP	False	
must have been reading our site because they finally ported their popular OBJECT_A application to OBJECT_B.	NO_COMP	False	
Yawn... OBJECT_A phones are rapidly becoming better spec'd out than the OBJECT_B.	BETTER	True	
These great apps will help you get better photos on your OBJECT_A or OBJECT_B smart phone.	NO_COMP	False	
From an end user perspective, the OBJECT_A , OBJECT_B and even the Windows Phone are providing better functionality than the BlackBerry.	UNCLEAR	True	
iHater muck-raking is useless because a 90% working OBJECT_A 4 is still better than a 95% working OBJECT_B or Symbian or RIM crapphone.	NO_COMP	False	
Make it a unique one a better one than OBJECT_A and OBJECT_B.	NO_COMP	False	
While we find this better in implementation that the OBJECT_A, it's still more limited than OBJECT_B.	NO_COMP	False	
There is nothing the OBJECT_A can do that an equally powerful OBJECT_B device can't do and more and better.	WORSE	True	
I went GS3 over OBJECT_A simply because I prefer the OBJECT_B operating system.	WORSE	True	
OBJECT_A didn't out pace the OBJECT_B this year, it just sold slightly better in America.	BETTER	True	
Not to mention that the OBJECT_A and OBJECT_B phones deliver a far superior user experience overall.	NO_COMP	False	
The reason is simple: Apple's OBJECT_A is perceived by customers to be a better device than any OBJECT_B handset.	BETTER	True	
10 Things OBJECT_A Does Better Than OBJECT_B OS	BETTER	True	
OBJECT_A phones have better processing power than OBJECT_B	BETTER	True	
Just another step towards showing that OBJECT_A is ultimately better than the OBJECT_B.	BETTER	True	
The OBJECT_A OS Google Maps app is better integrated than the OBJECT_B app.	BETTER	True	
The version for the OBJECT_A was pathetic , and the OBJECT_B version is no better.	UNCLEAR	True	
OBJECT_A phones may have eclipsed the OBJECT_B in specs, and the UI is only getting better.	BETTER	True	
The OBJECT_A may just blow us away again, regardless of how many of you think OBJECT_B is so superior.	NO_COMP	False	
It's better than any OBJECT_A or OBJECT_B phone I've tested thus far.	NO_COMP	False	
EVERYONE that bothers to do research knows OBJECT_A can do more and is better than the OBJECT_B.	BETTER	True	
That's because certain products or services do better on certain carriers or devices, and it's possible to target ads at that level on OBJECT_A by not OBJECT_B.	NO_COMP	False	
In reply to Only a hill: "The OBJECT_A has a notoriously inaccurate internal compass, but most OBJECT_B handsets are better".	WORSE	True	
Its better specs will make it more competitive against the OBJECT_A 4S and OBJECT_B superphones.	NO_COMP	False	
OBJECT_A provides better Utility to us than an equivalent OBJECT_B.	BETTER	True	
I think Apple is doing this because better apps is pretty much the only thing that's better about the OBJECT_A than OBJECT_B.	BETTER	True	
The OBJECT_A is older and has a broader and better range of applications available than in the OBJECT_B Market.	BETTER	True	
Owning an OBJECT_A or OBJECT_B smartphone just got even better with Pebble , the first watch designed for the 21st century.	NO_COMP	False	
It's all down to personal preference just because your happier with OBJECT_A doesn't mean OBJECT_B users are using an inferior device.	UNCLEAR	True	
Google shouldn't have mandated an inferior map app on the OBJECT_A (as opposed to OBJECT_B).	WORSE	True	
I can say, hands down, the OBJECT_A/iPod touch UI is much better implemented than OBJECT_B is on the Droid.	BETTER	True	
Microsoft Windows Phone 8 review: Better than OBJECT_A or OBJECT_B?	UNCLEAR	True	
I, and millions of others, like my OBJECT_A better than the equivalent OBJECT_B.	BETTER	True	
The apps for the OBJECT_A are generally better than those for OBJECT_B (for example, consider The Weather Network apps).	BETTER	True	
There are a dozen OBJECT_A phones for which the hardware is superior to the OBJECT_B.	BETTER	True	
Overall, this is a great phone and definitely better than the OBJECT_A 5 because of its speed, screen size, screen quality, hardware, and OBJECT_B 4.0.4	NO_COMP	False	
I'm in the minority because I am using an OBJECT_A and not an OBJECT_B.	NO_COMP	False	
To me it is much better than OBJECT_A and OBJECT_B.	NO_COMP	False	
For web even good smart phone (OBJECT_A, OBJECT_B, etc.) is way better than ereader.	UNCLEAR	True	
There are OBJECT_A devices which have vastly superior battery life and screens than an OBJECT_B.	BETTER	True	
The OBJECT_A has a superior number of good apps, though OBJECT_B phones counter with good alternatives.	BETTER	True	
OBJECT_A seems to be better at offering a wider selection of models than OBJECT_B.	BETTER	True	
Otherwise, the hardware platform looks to be very competitive with OBJECT_A handsets, with many models having specs superior to those of the Apple OBJECT_B 4.	BETTER	True	
I love OBJECT_A because the OBJECT_B might be coming to Verizon and I could care less.	BETTER	True	
In my opinion its superior when compared to the built in email clients on OBJECT_A or  OBJECT_B.	NO_COMP	False	
This really better be good, because BlackBerry apps aren't that great compared to OBJECT_A or potentially OBJECT_B.	NO_COMP	False	
I am a family medicine physician , and for me OBJECT_A is still superior to the OBJECT_B ( i am talking about the personal use )	BETTER	True	
OBJECT_A is Robot Jesus because it breaks through that wall, but OBJECT_B will be even bigger.	WORSE	True	
I say this with sadness, because so far I like the OBJECT_A OS much better than OBJECT_B.	BETTER	True	
I sold off my OBJECT_A 4 thinking I would like the features of the OBJECT_B phone better.	NO_COMP	False	
Lots of people buy an OBJECT_A phone because it is cheaper than OBJECT_B.	BETTER	True	
If you happen to like OBJECT_A better, why make it a point to bash OBJECT_B constantly?	NO_COMP	False	
The OBJECT_A is cool, I think the SDK for OBJECT_B is a tick better and a bit...	WORSE	True	
that is why you consider your OBJECT_A better then OBJECT_B.	BETTER	True	
5 Ways The OBJECT_A Is Better Than OBJECT_B	BETTER	True	
Even better, it supports multiple book readers: OBJECT_A, OBJECT_B, Nook, Web.	NO_COMP	False	
We can't let him walk away thinking that his precious OBJECT_A is that  much better than OBJECT_B now can we?	NO_COMP	False	
SO is not a place for questions like which is better, OBJECT_A and OBJECT_B?	NO_COMP	False	
OBJECT_A getting worse battery life than an OBJECT_B???	WORSE	True	
If you look at the OBJECT_A or OBJECT_B devices, their graphics look a lot better than the Wii.	NO_COMP	False	
Any modern OBJECT_A phone today has the same level or better build quality than any OBJECT_B.	UNCLEAR	True	
Choose OBJECT_A or OBJECT_B.	NO_COMP	False	
OBJECT_A ok, OBJECT_B negotiable.	NO_COMP	False	
OBJECT_A & OBJECT_B Travel	NO_COMP	False	
OBJECT_A & OBJECT_B Antibiotics	NO_COMP	False	
Entertain your OBJECT_A or OBJECT_B.	NO_COMP	False	
OBJECT_A pillow OBJECT_B bed	NO_COMP	False	
OBJECT_A / OBJECT_B Exams $20.00	NO_COMP	False	
Pets: 1 OBJECT_A, 1 OBJECT_B	NO_COMP	False	
OBJECT_A And OBJECT_B Toys & Supplies .	NO_COMP	False	
or a OBJECT_A or OBJECT_B?	NO_COMP	False	
Two settings: OBJECT_A or OBJECT_B.	NO_COMP	False	
OBJECT_A scared of OBJECT_B	NO_COMP	False	
3.) OBJECT_A or OBJECT_B?	NO_COMP	False	
OBJECT_A/OBJECT_B issues slowly resolving	NO_COMP	False	
OBJECT_A OBJECT_B bird horse . . . .	NO_COMP	False	
Lost OBJECT_A/OBJECT_B reports?	NO_COMP	False	
THAT OBJECT_A SCRATCHES MY OBJECT_B!!	NO_COMP	False	
Lost a OBJECT_A or OBJECT_B?	NO_COMP	False	
OBJECT_A Policy: OBJECT_B Policy:	NO_COMP	False	
OBJECT_A Food & OBJECT_B Food	NO_COMP	False	
One OBJECT_A OBJECT_B per room.	NO_COMP	False	
(Your family OBJECT_A or OBJECT_B!)	NO_COMP	False	
Original OBJECT_A and OBJECT_B Paintings	NO_COMP	False	
OBJECT_A, OBJECT_B, and Mts.	NO_COMP	False	
OBJECT_A-boys, OBJECT_B-girls...	NO_COMP	False	
I care not for a man's religion whose OBJECT_A or OBJECT_B are not the better for it."	NO_COMP	False	
Your OBJECT_A or OBJECT_B has a much better sense of hearing than you do, so loud, unfamiliar sounds can be especially unsettling.	NO_COMP	False	
@Rogelio - I have been to OBJECT_A & OBJECT_B several times because my house is a few steps from theirs, Animal House Jupiter, and VIP.	NO_COMP	False	
But IMO they are better than trading your OBJECT_A for somebody else's OBJECT_B.	NO_COMP	False	
It is better to re-phrase this and say, "The OBJECT_A and OBJECT_B are sleeping peacefully on the mat."	NO_COMP	False	
I expected them to say the carpet needed replaced because OBJECT_A urine is much worse then OBJECT_B.	WORSE	True	
Many OBJECT_A and OBJECT_B lovers simply do without because of their allergies.	NO_COMP	False	
It's funny, because this sort of thing is completely out of favor in OBJECT_A training and behaviour, but is still 'acceptable' in OBJECT_B training.	NO_COMP	False	
// Class cast exception because "molly" will return a OBJECT_A object not a OBJECT_B	NO_COMP	False	
Thousands of OBJECT_A and OBJECT_B are put to death every year because owners do spay or neuter their pet.	NO_COMP	False	
Q: To a OBJECT_A..."What would you like the family to do about the OBJECT_B to make you feel better?	NO_COMP	False	
If a quarantine cannot be imposed because the OBJECT_A or OBJECT_B cannot be captured, the officer may kill the animal.	NO_COMP	False	
Protein and fat are much better energy sources for your OBJECT_A or OBJECT_B.	UNCLEAR	True	
Archetype is a superior raw OBJECT_A and OBJECT_B diet suitable for all life stages and sizes.	NO_COMP	False	
SHE'S SUCH A LITTLE PIGGY AND SHE LIKES OBJECT_A FOOD BETTER THAN HER OBJECT_B FOOD.	BETTER	True	
You have a OBJECT_A and a OBJECT_B and you can't keep them anymore because you're pregnant?	NO_COMP	False	
So i beat my OBJECT_A to death because the guy down the road beat his OBJECT_B to death.	NO_COMP	False	
With a play area, and a shop for all your fish, bird, OBJECT_A and OBJECT_B needs, The Parrot Place is like a pet shop, only better.	NO_COMP	False	
Tomorrow I won't make it to the gym because I have to take our OBJECT_A and OBJECT_B to my parents house about an hour away.	NO_COMP	False	
So for kids, looking for a robotic pet, what could be better than a robot OBJECT_A or OBJECT_B ?	NO_COMP	False	
I've had one full black OBJECT_A named XTC also known as "baby" or "Puppy" because he was the size of a OBJECT_B.	NO_COMP	False	
It's tough to treat them like a OBJECT_A or a OBJECT_B because they're so close to you.	NO_COMP	False	
We use only superior products and "Cutting Edge" tools to assure that your OBJECT_A or OBJECT_B remains happy and healthy.	NO_COMP	False	
Often because of their advanced age an animal shelter may deny the elderly the possibility of adopting a young OBJECT_A or OBJECT_B.	NO_COMP	False	
This was my favorite of this series, because I love Halloween and haunted castles, and was touched by the affection the OBJECT_A-OBJECT_B has for Jerry.	NO_COMP	False	
A OBJECT_A and OBJECT_B food store would have much better options and even then, the big chain ones tend to have crap too.:rolleyes:	NO_COMP	False	
They rage at me because I won't validate their belief in an afterlife where they will be rejoined with mommy, daddy and their beloved OBJECT_A or OBJECT_B.	NO_COMP	False	
We sacrifice a lot for our pets, but realize it is worth it when the OBJECT_A or OBJECT_B puts us in a better mood or relieves workday stress.	NO_COMP	False	
I bought it because my older male OBJECT_A was carrying around a stuffed OBJECT_B toy and I thought he might like the ""tail"" on this thing.	NO_COMP	False	
In this case, more is better so let the mixture soak overnight, and sponge it on your OBJECT_A or OBJECT_B to kill fleas instantly.	NO_COMP	False	
Jonson's knight doesn't just have a OBJECT_A - he totes around a OBJECT_B as well, though we never see her because she isn't let out of her bag.	NO_COMP	False	
I think this is because most people don't believe that their OBJECT_A or OBJECT_B will eat a pill.	NO_COMP	False	
4. A man that hath learned sympathy is better learned than the philosopher that will kick a OBJECT_A or a OBJECT_B.	NO_COMP	False	
The world is divided into "OBJECT_A people" and "OBJECT_B people," each passionately believing that their preferred pet is superior.	NO_COMP	False	
You're adding them, I assume, because in OBJECT_A, OBJECT_B, and Horse meat are all taboo from your perspective.	NO_COMP	False	
Now you can see the many powerful ways technology is far better than the do-it-yourself approach to finding a lost OBJECT_A or OBJECT_B.	NO_COMP	False	
He's the best pet that you can get, Better than a OBJECT_A or OBJECT_B.	NO_COMP	False	
I love these things because they keep OBJECT_A and OBJECT_B food fresh.	NO_COMP	False	
My question is because she is so small can we use OBJECT_A clippers on her for the first time and then go out to purchase OBJECT_B nail clippers.	NO_COMP	False	
Everything that the OBJECT_A command does, OBJECT_B does it better.	WORSE	True	
You can't keep 'em outdoors because some passing OBJECT_A or OBJECT_B will provoke them to spray.	NO_COMP	False	
So I decided to try this OBJECT_A toothpaste because I have searched everywhere and no one has the four paws OBJECT_B (white) toothpaste.	NO_COMP	False	
So when these poor babes see a friendly OBJECT_A or OBJECT_B approach, they scream, throw stones or worse.	NO_COMP	False	
Malia and Sasha named the OBJECT_A "Bo" because they had a cousin with a OBJECT_B of the same name, and because their grandfather's nickname was "Diddley."	NO_COMP	False	
As a matter of fact Mrs. Persis, the housekeeper at Halkin Street, and Hignett fight OBJECT_A and OBJECT_B--it will be much better to part them.	NO_COMP	False	
This reminds me of the arguments that I hear from people who don't accept evolution because they have never seen a OBJECT_A give birth to a OBJECT_B.	NO_COMP	False	
If your OBJECT_A or OBJECT_B has pustules causing bald spots or staph infections from itching, there is nothing better.	NO_COMP	False	
I used to put my OBJECT_A food in the bathroom because my OBJECT_B won't go in because he is afraid of the bathtub.	NO_COMP	False	
How many times have you grabbed a bag of OBJECT_A or OBJECT_B food because it's the same brand your parents used to [...]	NO_COMP	False	
The Bonny Blog deserves a bunch of follows-the posts will make you feel better, and often there's a OBJECT_A or a OBJECT_B.	NO_COMP	False	
All of our OBJECT_A and OBJECT_B treat recipes contain no wheat, no corn and no soy which means better digestion and a healthier and happier pet.	NO_COMP	False	
And either a OBJECT_A or a OBJECT_B is a way better choice than any other possible pet.	UNCLEAR	True	
I am sure his OBJECT_A brother will thank me when he comes home a much better OBJECT_B.	NO_COMP	False	
Egypt - Not all place names should be turned into a name for your child... maybe this would be better on your OBJECT_A or OBJECT_B?	NO_COMP	False	
Modify the OBJECT_A class to include a new instance variable weight (double) and the OBJECT_B... better.	NO_COMP	False	
Should you or your OBJECT_A-OBJECT_B drink a pyrethoids you would experience dry mouth because it will close the saliva glans temporary.	NO_COMP	False	
It's impossible to determine whether a OBJECT_A is behaving in an unusual manner because it smells an earthquake coming or a OBJECT_B across the street.	NO_COMP	False	
Collars are great because they visually mark your OBJECT_A or OBJECT_B as being part of a family.	NO_COMP	False	
Actually, we're pretty sure he doesn't know he's a OBJECT_A because he acts more like a OBJECT_B.	NO_COMP	False	
This might mean they don't have Sprocket around, but mabye this new Family could have another Muppet OBJECT_A or better yet, a Muppet OBJECT_B, who hates the Fraggles.	WORSE	True	tricky
The recall by Natura because of salmonella contamination has now expanded to include all Natura dry OBJECT_A and OBJECT_B foods with a range of expiration dates.	NO_COMP	False	
The latter will work topically and internally because the OBJECT_A or OBJECT_B will lick their fur and ingest the herbs.	NO_COMP	False	
I kinda feel like God gave me back my OBJECT_A because he knew the OBJECT_B was going.	NO_COMP	False	
I need this vacuum because I have a OBJECT_A, a OBJECT_B and a hamster and 3 children at home one with serious respiratory issues.	NO_COMP	False	
This can be a OBJECT_A or a OBJECT_B but surprisingly to some,it could also be you, or worse, your child.	NO_COMP	False	
What better way to save a spot in your book that with your favorite LOL OBJECT_A or OBJECT_B?	NO_COMP	False	
-For a non-mega pet store, Target had the better deals on most items, although Giant and Shoppers Food Warehouse had comparable prices on OBJECT_A and OBJECT_B food.	UNCLEAR	True	comparison between Target and other stores
I hope to find one that offers a OBJECT_A/OBJECT_B combo box because I don't want to shell out money for 2 different ones.	NO_COMP	False	
We originally created the sites because there was no place on the Internet to share the joy of having a OBJECT_A or a OBJECT_B member of the family.	NO_COMP	False	
Now our new product delivers superior De-Shedding for your OBJECT_A or OBJECT_B.	NO_COMP	False	
Menu Foods is the Canadian company that had to recall 95 brands of moist OBJECT_A and OBJECT_B food because of the contamination.	NO_COMP	False	
Two recent studies about OBJECT_A and OBJECT_B behavior have reignited the age-old debate about which pet is better.	NO_COMP	False	
Does your OBJECT_A or OBJECT_B die because it only drinks when it's thirsty?	NO_COMP	False	
I love this idea because I volunteer at the Randolph County Humane Society and I wanted an easy cheap way to make OBJECT_A/OBJECT_B beds.	NO_COMP	False	
I left the apartment, with our OBJECT_A, OBJECT_B because we were very ill.	NO_COMP	False	
This black guy rolled up next to his OBJECT_A on a OBJECT_B believe it or not.	NO_COMP	False	
A OBJECT_A and OBJECT_B rental services are available on site.	NO_COMP	False	
I'll have OBJECT_A/OBJECT_B transportation so moving around won't be an issue.	NO_COMP	False	
MOTHER (laughing) Tiny ain't got no OBJECT_A, he ain't even got a OBJECT_B.	NO_COMP	False	
Leucadia OBJECT_A is one of the best shops to buy your new "OBJECT_B".	NO_COMP	False	
Riding against traffic only adds the speed of the OBJECT_A to the speed of the OBJECT_B.	NO_COMP	False	
Colorful ti tanium ti bolts screws?for bike OBJECT_A motor OBJECT_B? ?	NO_COMP	False	
Suddenly the OBJECT_A is in front of a moving OBJECT_B.	NO_COMP	False	
Who needs a OBJECT_A when you have access to the 'Donky' multi-use OBJECT_B!?	NO_COMP	False	
He called his lowrider OBJECT_A and OBJECT_B club "Taste of Latin."	NO_COMP	False	
OBJECT_A, OBJECT_B rental and laundry service available and doctor on call	NO_COMP	False	
Guests May Also Take Advantage of the Internet Access, OBJECT_A Park and OBJECT_B Hire Service.	NO_COMP	False	
This is pretty much the equivalent of an automatic OBJECT_A in the OBJECT_B world.	NO_COMP	False	
Were you in on a OBJECT_A or in a OBJECT_B?	NO_COMP	False	
Police OBJECT_A-OBJECT_B collision under investigation	NO_COMP	False	
They live a OBJECT_A-lite lifestyle and sometimes escape the city to go OBJECT_B touring.	NO_COMP	False	
OBJECT_A while riding a OBJECT_B	NO_COMP	False	
All of these are accessible by OBJECT_A or OBJECT_B.	NO_COMP	False	
SDOT is anti-OBJECT_A and OBJECT_B fanatic.	NO_COMP	False	
All items are visible from a OBJECT_A or OBJECT_B.	NO_COMP	False	
Solar OBJECT_A tires are more efficient than racing OBJECT_B tires.	BETTER	True	
We cannot replace OBJECT_A/truck traffic with OBJECT_B traffic.	NO_COMP	False	
You can also hire a OBJECT_A or OBJECT_B from reception.	NO_COMP	False	
She tells him to take her home and they load the OBJECT_A in his OBJECT_B.	NO_COMP	False	
OBJECT_A vs. OBJECT_B accident Sunday, in Treynor	NO_COMP	False	
(A OBJECT_A) is way better than a OBJECT_B.	BETTER	True	
Just because a OBJECT_A and OBJECT_B collided on a road, it doesn't make it a crime, Mr. Gibson said.	NO_COMP	False	
I had a OBJECT_A accident because someone opened their OBJECT_B door.	NO_COMP	False	
If I know that you are a OBJECT_A, I know roughly what to expect of your top speed, and will try to safely navigate past you... not try to hit you just because I know that you won't damage my OBJECT_B.	NO_COMP	False	
256kbps VBR encoding in MP3 or AAC form is far better than any of my common listening environments pander to (ear buds on OBJECT_A, or Bluetooth to OBJECT_B radio while driving).	UNCLEAR	True	
That's false, putting the OBJECT_A before the horse, because the Dutch used a great deal of OBJECT_B transportation before there were any bikeways.	NO_COMP	False	
Also it is nice because a OBJECT_A has a lower depreciation rate than a OBJECT_B.	BETTER	True	tricky
A bit like complaining because a OBJECT_A isn't a OBJECT_B.	NO_COMP	False	
There was a time when we were homeless, living out of her OBJECT_A, because all I had was a BMX OBJECT_B."	NO_COMP	False	
We think they'd be better off with an actual OBJECT_A, or perhaps a OBJECT_B, or a Segway.	NO_COMP	False	tricky
Although I can rollerskate, ride a OBJECT_A, and drive a OBJECT_B, I can neither ice skate nor swim because of my balance, coordination, time, and fear.	NO_COMP	False	
But, ironically, on the same streets where I can't drive a Kei OBJECT_A because they are too dangerous, I can ride my 1972 Raleigh 3spd OBJECT_B.	NO_COMP	False	
I had been riding a OBJECT_A back and forth to work for several years because my OBJECT_B broke down beyond my financial ability to have it repaired.	NO_COMP	False	
I once heard a guy threaten to murder his next door neighbor's little kids because one of them scratched his OBJECT_A with their OBJECT_B, my neighbor says.	NO_COMP	False	
The OBJECT_A movement seems to be accelerating in a region known far better for its love affair with the OBJECT_B.	BETTER	True	
Just because you have a OBJECT_A or a OBJECT_B doesn't mean you can't share the road safely and happily.	NO_COMP	False	
We can also help you rent a OBJECT_A, motorcycle or OBJECT_B with which you can discover better Florence.	NO_COMP	False	
Why ride hundreds of miles on a OBJECT_A when you can drive in a OBJECT_B, or better yet fly in a plane?	NO_COMP	False	
I have opted to not own a OBJECT_A because I can certainly survive with the public transit system and a OBJECT_B.	NO_COMP	False	
 Protected bikeways also are a powerful symbol of democracy, because they show that a citizen on a $30 OBJECT_A is equally important to one in a $30,000 OBJECT_B.	NO_COMP	False	
Perhaps that's why driver are so courteous to bike riders there, because they appreciate that it's a OBJECT_A in front of them, and not another OBJECT_B.	NO_COMP	False	
I'd like better information on road closures and maintenance - up-to-date info on all activities that significantly affect transportation by OBJECT_A OR OBJECT_B.	NO_COMP	False	
Would it protect my noggin better in the chance of a OBJECT_A-vs-OBJECT_B mishap?	NO_COMP	False	
Where there isn't room in the far right lane for a OBJECT_A AND a OBJECT_B, I will occupy the center of that lane, because I don't want people trying to squeeze by me at 40mph in that narrow space.	NO_COMP	False	
I walked everywhere because I did not have a OBJECT_A, and took the bus or my OBJECT_B.	NO_COMP	False	
Then you would type, "I don't want a OBJECT_A because I have a OBJECT_B."	NO_COMP	False	
The OBJECT_A may turn out to be a much better product than the OBJECT_B originally envisioned .	BETTER	True	
Adolf Hitler on a OBJECT_A would be a better person than Albert Schweitzer in a OBJECT_B	BETTER	True	
Trip lengths by OBJECT_A are up in Copenhagen - and OBJECT_B trips are down - simply because it's a pain to drive in the city because of all the construction at the moment.	NO_COMP	False	
I know a few cases of dog having bad heart problems because their owner would make them run behind a OBJECT_A or a OBJECT_B.	NO_COMP	False	
Yet Orcutt's main support for the tax comes from his belief that riding a OBJECT_A is worse than driving a OBJECT_B for the environment.	WORSE	True	
That my employer does not pass these costs along (like they do with OBJECT_A parking) might be because the building management does not explicitly charge for OBJECT_B parking.	NO_COMP	False	
I am currently looking for a job, and because I already commute everywhere on my bike and live OBJECT_A free, I thought that I might look into being a OBJECT_B courier.	NO_COMP	False	
It is great that I can be here and take my medications and not be in a OBJECT_A or on a train (or worse, a OBJECT_B lol).	BETTER	True	tricky
Another illustration of how OBJECT_A lanes are counterproductive: I recently had to swerve out of the bike lane and into the traffic stream because there was a parked OBJECT_B blocking the bike lane.	NO_COMP	False	
I like having a OBJECT_A, not as nice as yours but a lot better than a OBJECT_B.	BETTER	True	
I was stationed in Germany ( Aschaffenburg ) near Frankfurt in the US Army Corps of Engineers and wanted to buy a OBJECT_A because all I had was my OBJECT_B as transportation.	NO_COMP	False	
One OBJECT_A OBJECT_B was covered with ice because the door was opened.	NO_COMP	False	
I have a OBJECT_A and it could easily be three weeks where I don't touch it because it's smarter to walk, OBJECT_B or take the bus or metro to most destinations.	WORSE	True	tricky
This is partly because it is smaller and more nimble in the same way a OBJECT_A is smaller and more nimble than a OBJECT_B, but it's also because the simple fact is that lots of people ride bikes.	BETTER	True	
Do yourself a favor, park (or better yet sell) the OBJECT_A, ride a OBJECT_B or take public transportation.	BETTER	True	tricky
You can do it because you personally are looking for a alternative to the OBJECT_A or a way to decrease the use of the ICE so you decide to use a OBJECT_B.	NO_COMP	False	
Long ago, I was in a similar situation, after getting fired from my OBJECT_A messenger job in SF because I had to be off work after getting hit by a OBJECT_B.	NO_COMP	False	
I said the police seemed to have got above themselves, and that the Chief Whip was mainly in trouble because he rode a OBJECT_A instead of sprawling in a chauffeured OBJECT_B.	NO_COMP	False	
Maybe it's because I always expect a OBJECT_A to dip into the OBJECT_B lane without giving a shit when I'm riding but I fear that someone else might not be as experienced as a rider.	NO_COMP	False	
Nearly half the OBJECT_A rides that occur in Beijing are less than five kilometers, a distance that can be better travelled via OBJECT_B or walking.	WORSE	True	better at short distances
People seems to forget that Chinese people uses OBJECT_A because they don't have much money to buy a OBJECT_B!	NO_COMP	False	
it's perfect for a summer vacation because you are really close to the beach (5 min by OBJECT_A or 10' by OBJECT_B) and the city cen...	NO_COMP	False	
I called Shadyside Honda because it was the dealer that was best situated so that when they had my OBJECT_A I could still get from the shop to home and to work on my OBJECT_B.	NO_COMP	False	
Then, we need to take alternative transportation seriously, and make it better to take busses or OBJECT_A (in this wonderful climate) or OBJECT_B pool.	NO_COMP	False	
This fish does not need a OBJECT_A, because it has a OBJECT_B!	NO_COMP	False	
A OBJECT_A, after all, is absolutely not a OBJECT_B - it can stop faster, gives a better field of view, and is much more efficient when moving than when stopped.	BETTER	True	
Comparing them is like saying a OBJECT_A hitting you at 90mph shouldn't kill you because a OBJECT_B hitting you at 5mph wouldn't kill you.	NO_COMP	False	
So I can share this secret: A OBJECT_A is better than a OBJECT_B.	BETTER	True	
5. Just because you ride a OBJECT_A doesn't mean you are better than drivers, it only means you can't afford a OBJECT_B.	NO_COMP	False	
They have that personal relationship with me, because I am on the OBJECT_A and it's easier to approach me than it is somebody in the OBJECT_B, Raines said.	NO_COMP	False	
For all of the arguments to the effect that because this was a bicyclist it is "understandable" I want you to go back and substitute the word Tractor or "slow moving OBJECT_A" instead of OBJECT_B.	NO_COMP	False	
Seven months on, he can no longer ride a OBJECT_A or drive a OBJECT_B because the stroke left him with half the peripheral vision in his left eye.	NO_COMP	False	
Last night, the Tigers lost a baseball game because Jack Cust, who if he was a OBJECT_A or a OBJECT_B would be equipped with squares for wheels, beat out an infield single in the 11th inning.	NO_COMP	False	
Is a motor OBJECT_A better than a OBJECT_B?	BETTER	True	question
That doesn't mean that a OBJECT_A is superior to a OBJECT_B.	NO_COMP	False	
Some may think that riding a OBJECT_A on busy roads is a bad idea, but it's environmentally friendly and good for your health, plus it's better and cheaper than owning a OBJECT_B.	BETTER	True	
Or do you think OBJECT_A seller win OBJECT_B seller because they sell more bikes.	NO_COMP	False	
1. Roof Mounted OBJECT_A Racks: This is a convenient arrangement because the back of the OBJECT_B is not blocked in any way.	NO_COMP	False	
Choosing vacation rentals and lodging located in the heart of Sunriver means you can leave the OBJECT_A behind and explore on foot or, better yet, OBJECT_B.	WORSE	True	
The campaign enraged OBJECT_A advocates because it seemed to mirror the placement of white Ghostbikes across the city, symbols of fatal OBJECT_B-v-bike smashes.	NO_COMP	False	
There is no better rush than the feel of traveling great distances with your OBJECT_A and discovering new places that you normally don't appreciate as well with your OBJECT_B.	BETTER	True	tricky
don't worry about blinding drivers because OBJECT_A headlights are many times brighter than any OBJECT_B light.	NO_COMP	False	
I cannot think of a better solution for keeping the front wheel of a OBJECT_A stable when traveling with your bike hanging on the rear bike rack of a OBJECT_B.	NO_COMP	False	
However, I have no problem with a portion of the taxes I pay being used for Muni because I understand how very much I benefit from Muni's existence whether I take Muni, OBJECT_A or drive my OBJECT_B.	NO_COMP	False	
Scooter rides are a great way to take in the Emerald Coast's natural beauty because they are more intimate than a OBJECT_A, but require far less effort than a OBJECT_B.	BETTER	True	
Remember the guy who drives his OBJECT_A because nobody will approve him for a OBJECT_B loan?	NO_COMP	False	
So unless you want OBJECT_A to smash OBJECT_B better let them share the road with other vehicules.	NO_COMP	False	
i used to have a motorbike and sold it because i'm just stuck in traffic on queen/spadina/front. now i just ride my OBJECT_A everywhere on wknds and only use the OBJECT_B to get to work.	NO_COMP	False	
Moreover, when going by OBJECT_A, landscapes and sightseeing places can be seen better than when hurrying by OBJECT_B.	BETTER	True	
34. OBJECT_A OR OBJECT_B? - Fall	NO_COMP	False	
(Fall, OBJECT_A, OBJECT_B) ENGL 304.	NO_COMP	False	
OBJECT_A AND OBJECT_B	NO_COMP	False	
8) OBJECT_A or OBJECT_B?	NO_COMP	False	
OBJECT_A 1983 through OBJECT_B 1985	NO_COMP	False	
OBJECT_A & OBJECT_B Olympic Games	NO_COMP	False	
OBJECT_A/OBJECT_B Energy Efficiency	NO_COMP	False	
(4) OBJECT_A/OBJECT_B Olympic Games;	NO_COMP	False	
("OBJECT_A Studies and OBJECT_B Rambles").	NO_COMP	False	
I OBJECT_A and OBJECT_B.	NO_COMP	False	
OBJECT_A 2003 and OBJECT_B 2004	NO_COMP	False	
OBJECT_A and OBJECT_B schools	NO_COMP	False	
OBJECT_A MPG 20.9/ OBJECT_B 18.8	NO_COMP	False	
20. OBJECT_A or OBJECT_B?	NO_COMP	False	
OBJECT_A or OBJECT_B [ 2 ].	NO_COMP	False	
OBJECT_A 1557 - OBJECT_B 1558 Summary	NO_COMP	False	
OBJECT_A and OBJECT_B.	NO_COMP	False	
Enjoy this OBJECT_A / OBJECT_B reading.	NO_COMP	False	
Why OBJECT_A/OBJECT_B?	NO_COMP	False	
OBJECT_A/OBJECT_B Housing	NO_COMP	False	
In OBJECT_A or OBJECT_B?	NO_COMP	False	
OBJECT_A OBJECT_B Spring Fall	NO_COMP	False	
t.tays on OBJECT_A and OBJECT_B.	NO_COMP	False	
OBJECT_A or OBJECT_B? - Fall 24.	NO_COMP	False	
OBJECT_A and OBJECT_B bird populations	NO_COMP	False	
And because parsley is available year round, it's good in OBJECT_A and good in OBJECT_B.	NO_COMP	False	
The only thing worse than a disappointing season is OBJECT_A, spring and OBJECT_B with no football.	NO_COMP	False	
So like many people you probably notice you get worse gas mileage in the OBJECT_A than in the OBJECT_B.	WORSE	True	
Honestly the OBJECT_A medals have been better than the OBJECT_B medals since 1992 with Albertville's.	BETTER	True	
We found the area beautiful in the OBJECT_A and even better in the OBJECT_B.	WORSE	True	
I confess that I like the OBJECT_A Olympics better than the OBJECT_B games.	BETTER	True	
I have cars with both, and the cloth is infinitely better in OBJECT_A/OBJECT_B extremes.	UNCLEAR	True	
Current tires are quieter, ride smoother, and handle 1000% better than the originals in both OBJECT_A and OBJECT_B.	NO_COMP	False	
Not having power in OBJECT_A is bad, but in a lot of ways I think being without power in OBJECT_B is worse.	BETTER	True	tricky
The technology is always getting better to block out hot sun in OBJECT_A and keep warm air inside in OBJECT_B.	NO_COMP	False	
It would be great in both OBJECT_A or OBJECT_B because of the heating and aircon.	NO_COMP	False	
If you have a warm OBJECT_A you are going to have scorpions worse throughout the OBJECT_B.	NO_COMP	False	
More than a half a million Americans experience a OBJECT_A depression, but are better come OBJECT_B.	NO_COMP	False	
Plan, work hard in, and enjoy your two months of OBJECT_A because OBJECT_B will not wait.	NO_COMP	False	
Soon, the terrain got much steeper and I advanced up a route that seemed better for OBJECT_A than OBJECT_B skiing.	BETTER	True	
Especially when you are studying, it is better to plan them during OBJECT_A and OBJECT_B holiday.	NO_COMP	False	
Eagle carcasses retrieved in the fall and OBJECT_A are generally in better shape than carcasses found in the OBJECT_B.	BETTER	True	
We've had an uncommonly mild fall and OBJECT_A, with only a few unbikeably frigid days-on balance, no worse than the heat of the OBJECT_B.	NO_COMP	False	
I don't know why; Thriller just seems better for OBJECT_A than OBJECT_B, and a nice cozy mystery for cold March.	BETTER	True	
Great during OBJECT_A months, even better during OBJECT_B.	WORSE	True	
Dryness is essentially a OBJECT_A problem, because humidity is high in OBJECT_B.	NO_COMP	False	
It is so ugly in the OBJECT_A and not much better in the OBJECT_B.	NO_COMP	False	
But i notice that it is at its worse in the dead of OBJECT_A, and then clears up in the OBJECT_B.	NO_COMP	False	
I LOOOVVVVEEE OBJECT_A, but even i am missing OBJECT_B :/ mainly because i have school.	NO_COMP	False	
Admits beers are better "crisper and cleaner" in OBJECT_A but says they mature much more rapidly in OBJECT_B.	UNCLEAR	True	
Especially since it is OBJECT_A in the Northern Hemisphere and the cap melting, which has gotten worse every year, won't occur until OBJECT_B.	NO_COMP	False	
We stayed in OBJECT_A so the concrete ombiance was better suited for hot OBJECT_B nights.	NO_COMP	False	
MINI's OBJECT_A tyres have been specially engineered to operate much better than OBJECT_B tyres at temperatures below 7°C.	BETTER	True	
If we have a strong OBJECT_A and fall, and weaker OBJECT_B and Spring we have a better budget scenario.	NO_COMP	False	
Optimal humidity will help you stay healthy and feel better all OBJECT_A long and in dry OBJECT_B months.	NO_COMP	False	
The eruption was worse in OBJECT_A and better in OBJECT_B.	WORSE	True	
Phormiums that are well watered during OBJECT_A will be much better adapted to deal with OBJECT_B cold.	NO_COMP	False	
Huang believes this year has been worse for West Nile simply because the mosquito population is larger because we had a mild OBJECT_A and a wet spring and OBJECT_B.	NO_COMP	False	
Clearly this is better to correct in the warmer months of OBJECT_A than the colder months of OBJECT_B.	NO_COMP	False	
So the blaze is only making matters worse for families who are watching from afar as their OBJECT_A and OBJECT_B grazing pastures are charred.	NO_COMP	False	
I'm 73 and have nothing better to do than camp and fish - OBJECT_A and OBJECT_B.	NO_COMP	False	
This is over the spring and OBJECT_A however, I imagine it would be much worse in the OBJECT_B.	BETTER	True	
If you get depressed in the OBJECT_A but feel much better in spring and OBJECT_B, you may have SAD.	NO_COMP	False	
English (Translate this text in English): Can close-out on good days in OBJECT_A, OBJECT_B is fine with better banks	NO_COMP	False	
Often (unless wind/ice is a factor), you can get better training done in the OBJECT_A than in the OBJECT_B.	BETTER	True	
I race better during the cooler months, late fall, OBJECT_A, and during spring, but not well during OBJECT_B.	BETTER	True	
Set against the breathtaking OBJECT_A, OBJECT_B, or fall backdrop of Lake Superior, let the Hampton... more	NO_COMP	False	
So - I figure its time to create a FAQ on why gas milage sucks worse in the OBJECT_A than in the OBJECT_B.	WORSE	True	
Thus they will be better in OBJECT_A than OBJECT_B.	BETTER	True	
Liu Jen-yi says bipolar disorder often gets worse when the seasons change, especially when going from spring to OBJECT_A or autumn to OBJECT_B.	NO_COMP	False	
Are folks betting that things will be better by OBJECT_A in this OBJECT_B of discontent?	NO_COMP	False	
It really screams OBJECT_A to me because I don't cold brew coffee in the OBJECT_B.	NO_COMP	False	
My Pendletons are quite varied, some OBJECT_A weight and others OBJECT_B weight, to better layer.	NO_COMP	False	
I'd say you're better off having both sets of tires, or OBJECT_A tires and OBJECT_B tires.	NO_COMP	False	
Providing superior customer OBJECT_A season, OBJECT_B and fall are perfect times for distribservice is one good example.	NO_COMP	False	
Fans in the OBJECT_A, lights in the OBJECT_B and your flock ( and herd) will be producing better all year.	NO_COMP	False	
Look at weather-related death rates in OBJECT_A and in OBJECT_B, and the case is overwhelming that warmer is better.	NO_COMP	False	
Also keep in mind that OBJECT_A blends will give you worse mileage than OBJECT_B.	WORSE	True	
As to the foam-on stuff, am I better off doing it in the OBJECT_A or OBJECT_B?	NO_COMP	False	
The housing is little better than tar-paper shacks, hot in OBJECT_A and cold in OBJECT_B.	NO_COMP	False	
In OBJECT_A the black flies and mosquitoes have their way with you and worse, having to sit on the dreaded frozen toilet seat in the OBJECT_B.	NO_COMP	False	
it's cold OBJECT_A at the moment, but I feel like during the OBJECT_B it would be ALOT better.	NO_COMP	False	
The latter factor contributed to a better fattening by grazing and more effective utilization of both OBJECT_A and OBJECT_B ranges.	NO_COMP	False	
Ask about our great rates for the OBJECT_A and better rates during the OBJECT_B.	WORSE	True	
In OBJECT_A my scalp becomes one giant flake but in OBJECT_B its barely worse than dandruff.	NO_COMP	False	
Snowboarding during OBJECT_A is a lot better than during OBJECT_B.	BETTER	True	
For this reason, you're likely to get better logs if they are harvested in OBJECT_A, rather than OBJECT_B.	BETTER	True	tricky
Last year they held up shipping during the OBJECT_A because of the OBJECT_B only tires.	NO_COMP	False	
Chamonix, better known as Mont Blanc, has become a real Mecca for OBJECT_A and OBJECT_B sports enthusiasts.	NO_COMP	False	
As a long time diesel owner I can tell you that OBJECT_A time fuel mileage mixed will be 20% worse of more than OBJECT_B driving.	WORSE	True	
Tastefully decorated, these condominiums offer moderate to superior Teton Village rentals for the OBJECT_A or OBJECT_B vacation traveller.	NO_COMP	False	
Do you feel sad during the OBJECT_A months and then feel better in the spring and OBJECT_B?	NO_COMP	False	
The better your insulation qualities, the more heat you'll block in OBJECT_A and retain in OBJECT_B, he says.	NO_COMP	False	
In cooler climates, the overall annual outcome can even improve the Star rating, as benefits from more OBJECT_A solar gain outweigh worse OBJECT_B comfort!	NO_COMP	False	
Maybe it is because I associate pies with spring and OBJECT_A more than autumn and OBJECT_B.	NO_COMP	False	
It's worse in the OBJECT_A time than in the OBJECT_B.	WORSE	True	
The NW Alpinist salopettes will be warmer in OBJECT_A and breath better in OBJECT_B than anything I have ever owned.	NO_COMP	False	
It´s OBJECT_A here and I think it comes out better in spring or OBJECT_B.	NO_COMP	False	
It's not electricity, because we use lightbulbs before sunrise and after sunset in OBJECT_A and OBJECT_B.	NO_COMP	False	
I don't know what is worse the OBJECT_A w/ the pool or the OBJECT_B with the heat on.	NO_COMP	False	
All we need is for OBJECT_A, OBJECT_B and Jaguar to start the trend.	NO_COMP	False	
We currently serve Audi, Volkswagen, Mini, OBJECT_A, and OBJECT_B.	NO_COMP	False	
Executive vehicles (including OBJECT_A, OBJECT_B and other executive marques)	NO_COMP	False	
Just look at the same era OBJECT_A, OBJECT_B, or Jaguar.	NO_COMP	False	
This includes several OBJECT_A and OBJECT_B Benz automobiles.	NO_COMP	False	
The real problem for OBJECT_A is not OBJECT_B.	NO_COMP	False	
Other brands like: Audi, OBJECT_A, Acura, Lexus don't offer yet a small SUV like OBJECT_B X1.	NO_COMP	False	
Ferrari, Porsche, OBJECT_A, OBJECT_B, Range Rover, etc).	NO_COMP	False	
They're off to strong starts in January - OBJECT_A , OBJECT_B , Audi .	NO_COMP	False	
OBJECT_A and OBJECT_B Unveil Models for Luxury Market	NO_COMP	False	
What's wrong with being OBJECT_A or OBJECT_B?	NO_COMP	False	
Fitment: They are specially designed for Luxury European cars such as OBJECT_A, OBJECT_B, AUDI, Porsche.	NO_COMP	False	
I suggest Grand Banks compares to Rolls Royce, rather than, say, a OBJECT_A Benz, or OBJECT_B.	NO_COMP	False	
Let try OBJECT_A ML (body on frame and OBJECT_B X5 series.	NO_COMP	False	
We also tested OBJECT_A and OBJECT_B.	NO_COMP	False	
It supported by VW/ Audi, OBJECT_A and OBJECT_B.	NO_COMP	False	
This is the OBJECT_A X5 and OBJECT_B ML direct competitor.	NO_COMP	False	
OBJECT_A & OBJECT_B Repair Lake Norman, NC	NO_COMP	False	
In fact, many 'supercars' will use OBJECT_A or OBJECT_B engines.	NO_COMP	False	
you OBJECT_A and OBJECT_B people are idiots.	NO_COMP	False	
All Car Tuning and Diagnostic Services specialising in OBJECT_A, OBJECT_B, Servicing, Volkswagen.	NO_COMP	False	
Try buying a OBJECT_A or OBJECT_B for that!	NO_COMP	False	
I believe it's quicker, I've sped away from many a OBJECT_A and OBJECT_B!	NO_COMP	False	
You probably can't afford a OBJECT_A Benz or OBJECT_B either.	NO_COMP	False	
Our team is experienced in all OBJECT_A and OBJECT_B models.	NO_COMP	False	
You've probably ridden behind a OBJECT_A or OBJECT_B diesel and not known it because they don't smoke and don't make clattering diesel sounds.	NO_COMP	False	
Caddy should not be chasing OBJECT_A, since Buick apparently wants to be Lexus then Caddy better aspire to be Rolls or Bentley or heck, at least OBJECT_B Benz.	UNCLEAR	True	
Going up against the OBJECT_A 5-series and OBJECT_B-Benz E-class, Lexus gave the GS better handling for the 2013 model year.	UNCLEAR	True	
Drivetrain Due to its much higher torque, the OBJECT_A X6 M does a much better job of transmitting its engine's horsepower to its wheels than the OBJECT_B-Benz G-Class.	BETTER	True	
Just funny to me how a less reliable machine can cost more because it looks better,   that goes for Bosch,  Dacor,  Sub-Zero,   OBJECT_A,  and OBJECT_B.	NO_COMP	False	
OBJECT_A doesn't have a Maybach anymore so they're able to make and take the S-Class to another level that Audi or OBJECT_B likely won't meet because they have their own uber luxury brand.	NO_COMP	False	
JP Morgan's Jose Asumendi rated OBJECT_A higher than OBJECT_B because of the manufacturer's product momentum, pricing-power and platform strategy.	BETTER	True	
In 30 minutes, EIGHT OBJECT_A/OBJECT_B/jaguar owners said they could not help me because they were either in a rush or "didn't know how to open their hoods".	NO_COMP	False	
it's simple OBJECT_A makes a superior car to OBJECT_B in this class.	BETTER	True	
This detail is particularly interesting on the X6, because OBJECT_A is applying an aggressive application of the four-door-coupe concept first seen on the OBJECT_B CLS, to the SUV/Crossover genre.	NO_COMP	False	
Utility The OBJECT_A X5 offers greater seating capacity than the OBJECT_B-Benz M-Class, making it a better choice for those who find themselves chauffeuring others around.	BETTER	True	
As for "GM's junk", GM has better statistical quality than OBJECT_A and OBJECT_B-Benz.	UNCLEAR	True	
There is no better place to see a OBJECT_A, an Audi and a OBJECT_B go head-to-head-to-head in a white-knuckle brawl for the finish line.	NO_COMP	False	
Much better looking than OBJECT_A or OBJECT_B.	NO_COMP	False	
Is a new car buyer wise to pay the premium for a OBJECT_A, Audi, or OBJECT_B and despite their high prices do they make better second-hand buys?	NO_COMP	False	
Is it true that you had the OBJECT_A X5, but that you bought an additional OBJECT_B because you thought the X5 was too big to go get coffee with?	NO_COMP	False	
OBJECT_A, OBJECT_B and Audi also make an appearance with the senior set, probably because they have money to spare and can't take it with them when they check out.	NO_COMP	False	
I use voice commands which in my experience works better than Honda's, OBJECT_A, or OBJECT_B.	NO_COMP	False	
The Leith OBJECT_A finance manager just came over from OBJECT_B a week ago, his price is retail $3200 for the 6/100k and he doesn't know how to find out how to get a better price.	NO_COMP	False	
Manufacturers like Ferrari, Honda, OBJECT_A, OBJECT_B too(me thinks) were here because of the limelight that they could be in.	NO_COMP	False	
Do you think people drive luxury cars, like a OBJECT_A Benz or a OBJECT_B, because of the great gas mileage?	NO_COMP	False	
The Germans have high labor costs as well but are doing just fine because either they're assembling in Eastern Europe or building expensive cars with higher margins (Audi, OBJECT_A, OBJECT_B).	NO_COMP	False	
The IS250's V6 would be cool: people underrate that engine largely because they haven't driven the equally dog-a-riffic OBJECT_A 323i or OBJECT_B C250, but it is smooth and revs nicely.	NO_COMP	False	
Those seeking a diesel that gets near or better than 40 mpg, meanwhile, can shop Audi, OBJECT_A-Benz or OBJECT_B.	NO_COMP	False	
It's no surprise to hear that Hyundai has recruited OBJECT_A designers (and some from OBJECT_B) because the i40 has more than a hint of Merc CLS about it.	NO_COMP	False	
And that's where the Q45 gets hurt no matter how good the car because Infiniti just does not have the image of Lexus, OBJECT_A and OBJECT_B.	NO_COMP	False	
And OBJECT_A is even loosing straight-line battles with the porkers over at OBJECT_B (the M6 looses out to the Sl600, and that's a shame because I hate the SL).	NO_COMP	False	
What they don't realize is that Cadillac is far superior to most of the OBJECT_A and OBJECT_B they hold so dear.	UNCLEAR	True	
Of course Volvo marketers would prefer you cross-shop the S80 against the E-Class OBJECT_A and 5 series OBJECT_B as well as the Audi A6, because then the $37,200 price tag will seem like a bargain.	NO_COMP	False	
Oh, and OBJECT_A and OBJECT_B don't want to make $15,000 cars because they want to be known only as prestigious and high end.	NO_COMP	False	
Also, Audi is selling better than OBJECT_A and OBJECT_B-Benz in Germany, which is the companies' home market, obviously.	UNCLEAR	True	
There are not huge aspirations for Malibu because the (midsize) segment here is not so big and is dominated by the premium brands like Audi, OBJECT_A and OBJECT_B.	NO_COMP	False	
I am so hoping they did a better job with this car because I love my OBJECT_A - but can we get something like what's in the OBJECT_B or the Cadillac CTS?	NO_COMP	False	
Drivetrain Due to its much higher torque, the engine of the OBJECT_A-Benz E-Class does a much better job of transmitting power to the wheels than the OBJECT_B 528.	BETTER	True	
For bold styling, the OBJECT_A-Benz CLA is a better choice, while the OBJECT_B 2 Series Coupe is arguably more thrilling to drive.	UNCLEAR	True	
As a fact in term of durability and comfiort , OBJECT_A is much better than any OBJECT_B.	BETTER	True	
This year, it's unlikely to finish better than third behind OBJECT_A and OBJECT_B-Benz...	NO_COMP	False	
With that said, I still feel as though OBJECT_A-Benz and OBJECT_B both produce much, much better-looking cars and SUVs than Lexus.	UNCLEAR	True	
Spend just a bit of time behind the wheel of one and you'll see that driving a Maserati vs a OBJECT_A or OBJECT_B is so much better it's not a difference in degree it's a difference in type.	UNCLEAR	True	
The Alfa Romeo Giulia's most sporty version will offer more power than rival models from OBJECT_A and OBJECT_B because it will use Maserati's Ferrari-derived 510-hp V-6 engine.	UNCLEAR	True	
But it was not quite that easy for Williams because the story of the race was not one of Williams-OBJECT_A domination but rather one of OBJECT_B-Benz getting ahead and then losing.	NO_COMP	False	
The OBJECT_A is more spacious, but the OBJECT_B is a better car in almost every other area.	WORSE	True	
Defending and vice champions Bruno Spengler and Gary Paffett also fell afoul of the unpredictable conditions with the OBJECT_A man narrowly getting the better of Spengler's OBJECT_B in sixth and seventh.	NO_COMP	False	
However, it's better than its OBJECT_A and OBJECT_B rivals.	NO_COMP	False	
So most German car manufacturers like Audi, VW, OBJECT_A and OBJECT_B will give you 10+ years of warranty on the chassis of the car because they all know that their cars will turn to rust in 5 or 6 years?	NO_COMP	False	
The rear seat of the ATS isn't any worse than the OBJECT_A 328i or the OBJECT_B-Benz C-Class.	UNCLEAR	True	
I'm guessing this CLA will have better luck in the USA than the OBJECT_A 318ti and OBJECT_B Coupe.	UNCLEAR	True	
The M4 is a standard OBJECT_A/Audi/OBJECT_B tire that provides superior comfort and some sportiness.	NO_COMP	False	
2-You must go pick her up in a nice car (OBJECT_A or OBJECT_B preferably) because now, almost any moldovan guy owns one and she has become used to it!	NO_COMP	False	
Truthly I've liked OBJECT_A as a company better than OBJECT_B for a while now.	BETTER	True	
Daimler faces fierce pressure from analysts despite enjoying record car sales at its core OBJECT_A-Benz brand, because OBJECT_B and Audi are selling more cars and reaping higher profit margins.	WORSE	True	
Much better than what OBJECT_A and OBJECT_B have done in my opinion.	NO_COMP	False	
Driving Mummy's Audi, OBJECT_A or OBJECT_B, you are clearly a superior being.	NO_COMP	False	
For the first time EVER there are some OBJECT_A models that handle better than their OBJECT_B counterparts.	BETTER	True	
The new V60 wagon, part of Volvo's plan to better compete with Audi , OBJECT_A , and OBJECT_B-Benz , just entered production today.	NO_COMP	False	
It boasts class-leading rear legroom-better than luxury sedans such as the OBJECT_A-Benz E-class, OBJECT_B 5 Series and Lexus LS.	NO_COMP	False	
@Alpha - That is like saying, would a OBJECT_A M5 or OBJECT_B S class lose value just because they offer cheaper options?	NO_COMP	False	
lexus is definitely on par with if not better than OBJECT_A, OBJECT_B, or audi.	UNCLEAR	True	
Jaguar is looking to expand beyond its current three-model line (and the upcoming F-Type roadster) to better compete with German rivals OBJECT_A, Audi and OBJECT_B.	NO_COMP	False	
If Chrysler or Jeep doesn't have a great designer just do what Kia and Hunday does , copy and paste from OBJECT_A and OBJECT_B even Audi and the result is better than this thing .	NO_COMP	False	
I really wanted a used OBJECT_A or OBJECT_B primarily because they were great handling rear-wheel drive cars.	NO_COMP	False	
Acura needs to market their vehicles better, Acura is not thought of as being as prestigious than OBJECT_A, Lexus and OBJECT_B even though their product is just as good if not better.	NO_COMP	False	
I personally never want to own a OBJECT_A/OBJECT_B/Audi, because I do not need or have a desire to own a luxury car.	NO_COMP	False	
Plus, there are so many better options like the OBJECT_A c-class estate, Audi A4 wagon, OBJECT_B 3 series touring, and so on.	NO_COMP	False	
Toyota created Lexus twenty years ago because it felt that it needed a specific brand cache to go against OBJECT_A, OBJECT_B, Audi, Cadillac, etc.	NO_COMP	False	
Since then OBJECT_A were always lacking in outright power compared to the Ferrari and OBJECT_B power units, and they had far worse reliability.	WORSE	True	
Of course, that hasn't stopped OBJECT_A and OBJECT_B making good money over the years, but that's because they can charge premium prices and people will still pay.	NO_COMP	False	
I've owned a OBJECT_A 3 series and test drove the OBJECT_B C250 and this car is so much better.	WORSE	True	
Also engineering goes to the OBJECT_A with always having the edge, better brakes, better suspension... they just make the speed and handling way more efficient than OBJECT_B does.	BETTER	True	
It is better you just go and buy a second hand OBJECT_A or OBJECT_B because the depreciation of the 2nd year onwards is very minimal.	NO_COMP	False	
The all-wheel-drive systems that OBJECT_A and OBJECT_B use are built from rear-wheel-drive cars and have the ability to send more than half the power to the rear for better handling.	NO_COMP	False	
i think this car is a far better deal than the OBJECT_A 5 series or OBJECT_B 320e.	UNCLEAR	True	
Where I live is actually a good case study really because on one road (Ogden Ave.) we have Lexus, Audi, OBJECT_A and OBJECT_B all right next to each other.	NO_COMP	False	
A better way to look at it is a person buying a Hyundai Genesis when they are used to a OBJECT_A 5 series or OBJECT_B Benz E class.	NO_COMP	False	
The handling, ride, and power are better than OBJECT_A, Lexus, OBJECT_B or any other import car.	NO_COMP	False	
Closer to OBJECT_A than OBJECT_B.	NO_COMP	False	
Food, OBJECT_A and OBJECT_B available.	NO_COMP	False	
Q: OBJECT_A or OBJECT_B?	NO_COMP	False	
OBJECT_A after OBJECT_B, oh dear?	NO_COMP	False	
I'll have OBJECT_A and OBJECT_B.	NO_COMP	False	
2.      Other than OBJECT_A and OBJECT_B                                    90	NO_COMP	False	
OBJECT_A, bourbon, OBJECT_B.	NO_COMP	False	
Paterson Treads on OBJECT_A, OBJECT_B	NO_COMP	False	
unlike OBJECT_A and OBJECT_B.	NO_COMP	False	
Craft OBJECT_A and OBJECT_B will be served.	NO_COMP	False	
Italian OBJECT_A and OBJECT_B	NO_COMP	False	
CADET OBJECT_A + OBJECT_B Bar	NO_COMP	False	
Taps OBJECT_A & OBJECT_B Merchants	NO_COMP	False	
$80; OBJECT_A, OBJECT_B or beverage included.	NO_COMP	False	
OBJECT_A, OBJECT_B and spirits.	NO_COMP	False	
OBJECT_A or OBJECT_B or tea?	NO_COMP	False	
It's OBJECT_A, not OBJECT_B.	NO_COMP	False	
Drink OBJECT_A, OBJECT_B and freshly brewed coffee.	NO_COMP	False	
Shipping OBJECT_A and OBJECT_B; and	NO_COMP	False	
OBJECT_A and OBJECT_B Off Premises	NO_COMP	False	
OBJECT_A, OBJECT_B, socially	NO_COMP	False	
OBJECT_A, OBJECT_B & Spirits	NO_COMP	False	
Gifts for OBJECT_A & OBJECT_B Lovers	NO_COMP	False	
All OBJECT_A, OBJECT_B, and Well $1 off	NO_COMP	False	
OBJECT_A, OBJECT_B and more.	NO_COMP	False	
That's good news because OBJECT_A is increasingly competing with spirits and OBJECT_B, both of which are enjoying higher per-capita consumption.	NO_COMP	False	
Moderate consumption of OBJECT_A, OBJECT_B, whisky or liqueur is known to be beneficial for improving health because of the radical scavenging action of antioxidants present in them.	NO_COMP	False	
Not only for sharing the time, the OBJECT_A (or OBJECT_B), the company, but also because they paid for the trip.	NO_COMP	False	
Just note that OBJECT_A bottles because of their greater mass and volume will require longer pasteurizing/flash/contact time than smaller thinner OBJECT_B bottles.	NO_COMP	False	
water mixed with some small amount of OBJECT_A or dirt or OBJECT_B) may be used in case of emergency, because dirty water is still essentially water.	NO_COMP	False	
And because many parents and other adults use alcohol socially - having OBJECT_A or OBJECT_B with dinner, for example - alcohol seems harmless to many teens.	NO_COMP	False	
Find out what time of the day the Better OBJECT_A Authority is looking to enjoy Sierra Nevada's Bigfoot Barley OBJECT_B Style Ale.	NO_COMP	False	
What better way to spend my college career than by learning about OBJECT_A, OBJECT_B, and cheese!	NO_COMP	False	
There is hardly a better place to sit beachside - and now you can enjoy the sunset here with a OBJECT_A or OBJECT_B in hand.	NO_COMP	False	
In a land with decidedly fewer OBJECT_A options, and way better OBJECT_B ones, this is overwhelmingly average.	WORSE	True	
But the jury is still out on whether OBJECT_A is better for the heart than OBJECT_B.	NO_COMP	False	
The prices are much better than the local grocery stores on OBJECT_A and OBJECT_B.	UNCLEAR	True	
red OBJECT_A and a movie by the fire... get some sports and some OBJECT_B because right now it looks like you're all dating	NO_COMP	False	
David, I totally agree with you than some cheeses go better with White OBJECT_A, however, I am more and more a cheese and OBJECT_B kinda-guy.	NO_COMP	False	
I lost my grape leaves because I used an airlock (like for fermenting OBJECT_A or OBJECT_B) on a half-gallon canning jar lid that came loose.	NO_COMP	False	
I'll buy it if it is worth it and I know that Samuel Smith can make a big OBJECT_A because they produce a barley OBJECT_B.	NO_COMP	False	
This is because of the Angel's share , that being the OBJECT_A/OBJECT_B/whiskey that evaporates during the aging process.	NO_COMP	False	
Miko : I drink because (a) I like OBJECT_A and OBJECT_B a lot, and I enjoy tasting and appreciating their qualities as beverages;	NO_COMP	False	
ught a beverage - say, OBJECT_A or OBJECT_B - just because you liked the bottle it came in?	NO_COMP	False	
The NDP has also opposed the sale of OBJECT_A and OBJECT_B in convenience stores, but has said the system could work better.	NO_COMP	False	
Let's make some OBJECT_A sorbet, because I am more than certain a OBJECT_B popsicle might be a little weird - or would it?	NO_COMP	False	
Cans are better for storage: Light and air affect the quality of the OBJECT_A (and all food products-including OBJECT_B, olive oil, and spices).	NO_COMP	False	
OBJECT_A and OBJECT_B are even worse for triggering the reaction, so I have the least risk with gin/tonic.	NO_COMP	False	
That's because Starbucks announced it will sell OBJECT_A and OBJECT_B in thousands of stores after 4 p.m.	NO_COMP	False	
Even better, you can get them to bring you OBJECT_A, OBJECT_B, and pints of ice cream, too.	NO_COMP	False	
If so, make your party even better by choosing wonderful OBJECT_A and OBJECT_B selections to go along with delicious cheeses.	NO_COMP	False	
You can buy this OBJECT_A cheaply and in bulk , but maybe you're better off just having a OBJECT_B.	WORSE	True	tricky
Children were allowed in the bar, because it was really a restaurant with a OBJECT_A and OBJECT_B license.	NO_COMP	False	
The $3.2 million expansion is necessary because of growth in Wright-Wisner's craft OBJECT_A and OBJECT_B segments, company officials said.	NO_COMP	False	
Quality, selection - I swear, this place has a better selection than Total OBJECT_A, even though there's just one little wall of OBJECT_B and a few coolers.	BETTER	True	
Different swimsuits for different folks.The OBJECT_A drinking British men avoid speedos while the OBJECT_B drinking and better diet eating French men want to show off their figures.	NO_COMP	False	
Add $5 OBJECT_A, OBJECT_B, and tasty snacks - Even better.	NO_COMP	False	
And I do not understand you rational: you let your 3 yr old to sip OBJECT_A and OBJECT_B because children and adults do not like the taste?	NO_COMP	False	
No surprise: any American could probably guess that American OBJECT_A drinkers in general tend to be better educated and wealthier than OBJECT_B drinkers.	BETTER	True	tricky
First was a report that OBJECT_A had an equal or better effect on health than red OBJECT_B.	UNCLEAR	True	
User Age Because InsideHook provides information regarding alcoholic beverages, including OBJECT_A, OBJECT_B and spirits, InsideHook is not intended for users under 21 years of age.	NO_COMP	False	
As a OBJECT_A, I have had much more enjoyable, as a barley OBJECT_B, it is better than I remembered.	NO_COMP	False	
OBJECT_A goes better, I must admit, but OBJECT_B is alright as well.	BETTER	True	
I would say this is a great OBJECT_A for OBJECT_B drinkers, but I have had way better from Ommegang.	NO_COMP	False	
And the consensus seems to be that a high-quality red organic OBJECT_A is better than OBJECT_B.	NO_COMP	False	
Sometimes OBJECT_A does go better with certain foods than OBJECT_B does.	BETTER	True	
Wash it down with a normal-size soda, a cup of coffee, or better yet a cocktail or a glass of OBJECT_A or OBJECT_B.	NO_COMP	False	
I watched this while drinking a Gnarly OBJECT_A OBJECT_B, partly because of the 9.7 alcoholic content in an 11 oz.	NO_COMP	False	
It's pretty fucked up in PA because supermarket mammoth Giant Eagle can sell OBJECT_A and OBJECT_B because they bought a bulk licence to be able to do it.	NO_COMP	False	
Gastropub is a British term for a restaurant that combines a public house atmosphere with better-than-average pub grub and serious OBJECT_A and OBJECT_B lists.	NO_COMP	False	
Anyway, Beef Carbonnade is cooked in beef stock and OBJECT_A (we used Guinness Extra Stout mostly because it was cheap) rather than cheap red OBJECT_B like the Bourguignon.	NO_COMP	False	
Although, I say "YAY" with the stipulation of "just don't drink huge amounts of OBJECT_A or large mixed drinks" because those have many more calories than OBJECT_B.	NO_COMP	False	
Here, Super Coop is at a disadvantage because they aren't licensed to sell hard alcohol; they only have OBJECT_A and OBJECT_B.	NO_COMP	False	
(I've always found poster sessions to be the best networking environment, better than coffee breaks or the OBJECT_A-and-OBJECT_B event on the first evening of a conference.	NO_COMP	False	
It's a great way to round out the week, and also fun because we'll have some OBJECT_A  and some of my favorite  local OBJECT_B and snacks .	NO_COMP	False	
Governor LePage has proposed modifying the Kid-Safe Products Law, mainly because the law could ban almost 2,000 common consumer products, including OBJECT_A and OBJECT_B, toothpaste and bicycles.	NO_COMP	False	
The "two-buck Chuck" remains in the fridge because on Friday nights, I swear off the OBJECT_A; the only thing I drink is OBJECT_B.	NO_COMP	False	
A decent store for OBJECT_A (though more OBJECT_B oriented), made better that they are next door to Lush.	NO_COMP	False	
We'll forgive the tiny tasting glasses (only OBJECT_A should come in 'flights') because they also served OBJECT_B in pints and some of it was even good.	NO_COMP	False	
The other section of the store (not connected, I'm guessing because of NYS law regarding liquor stores and OBJECT_A) had a very extensive OBJECT_B and liquor store.	NO_COMP	False	
If you're looking for quality and great prices, there is no better place to stock up on OBJECT_A, spirits, and high-gravity OBJECT_B than Grace's.	NO_COMP	False	
But things could be better because the dinner/bar/dessert tail end of our daily program is simply waiting for our anchor: the OBJECT_A/OBJECT_B program.	NO_COMP	False	
If someone in your party doesn't like OBJECT_A then have no fear because they do OBJECT_B tasting too!	NO_COMP	False	
Heck in pre-modern time OBJECT_A and OBJECT_B were health foods because they were often safer to drink than water, which was often contaminated.	NO_COMP	False	
The OBJECT_A list is better than the OBJECT_B list, but that, too, changes frequently.	BETTER	True	
A side-effect is very likely to be an increased status for OBJECT_A, probably gradually approaching the status of OBJECT_B, because for many people money really does talk.	NO_COMP	False	
In some ways, it's a more dynamic world than that of OBJECT_A, because the time from getting an idea to enjoying a completed OBJECT_B is so short.	NO_COMP	False	
A guy has a HBS called Strange Brew OBJECT_A & OBJECT_B Making Supplies and he wants to sue another company because they are named Strange Brewing Company?	NO_COMP	False	
I'm glad we liked the OBJECT_A pairing better than we liked the OBJECT_B pairing!	BETTER	True	
Along with the dish soap the 3 different things we used were OBJECT_A (they love it), OBJECT_B (they love that better!) and some ruby red grapefruit juice.	WORSE	True	tricky
I find that using a tart Belgian OBJECT_A like a lambic or oud bruin works even better than OBJECT_B when braising beef.	NO_COMP	False	
That's because it's illegal to send OBJECT_A, OBJECT_B or spirits through the mail in this country.	NO_COMP	False	
On The Grill There are few better when the pan is heated it up with OBJECT_A or OBJECT_B at the event.	NO_COMP	False	
Courtesy of Marylanders for Better OBJECT_A & OBJECT_B Laws, here's a summation of what was debated and discussed.	NO_COMP	False	
The spectacular Indian chicken enchiladas are better matched with OBJECT_A than with OBJECT_B.	NO_COMP	False	
Complex is not the word for this OBJECT_A, better than OBJECT_B is bold and fitting.	NO_COMP	False	
NOFO gift baskets are particularly interesting because they contain a mixture of packaged foods, freshly prepared foods, OBJECT_A, OBJECT_B & gift items from the retail store.	NO_COMP	False	
This means stale OBJECT_A or OBJECT_B is worse than fresh.	NO_COMP	False	
I think OBJECT_A matches food better than OBJECT_B.	BETTER	True	
Its OBJECT_A list is approachable, cocktails and OBJECT_B better than average, the service is excellent, and the prices are in line with the quality of the food.	NO_COMP	False	
- Pro version is available (OBJECT_A and OBJECT_B)!	NO_COMP	False	
But was it different in OBJECT_A or the OBJECT_B?	NO_COMP	False	
Worldwide delivery from OBJECT_A & OBJECT_B	NO_COMP	False	
OBJECT_A:  Two Britain, Australia, New Zealand:  One OBJECT_B:  Waiter!	NO_COMP	False	
1990: OBJECT_A 11 1/2, OBJECT_B 4 1/2	NO_COMP	False	
Excellent Participation from Africa, Asia, OBJECT_A, OBJECT_B, Middle East.	NO_COMP	False	
Wii U. OBJECT_A and OBJECT_B.	NO_COMP	False	
15 Years invested OBJECT_A,UK,OBJECT_B .	NO_COMP	False	
OBJECT_A & OBJECT_B - order by the 15th December	NO_COMP	False	
We also dispatch to OBJECT_A, OBJECT_B, Canada, and Australia .	NO_COMP	False	
Regular workshops with senior teachers from OBJECT_A and OBJECT_B.	NO_COMP	False	
I live in OBJECT_A and bought my piano in OBJECT_B.	NO_COMP	False	
OBJECT_A, Israel, Argentina OBJECT_B 85.5(W)3.7225CG	NO_COMP	False	
high school student exchange programme OBJECT_A - OBJECT_B	NO_COMP	False	
OBJECT_A, Canada, OBJECT_B?	NO_COMP	False	
We ship to the UK, OBJECT_A, OBJECT_B & Canada and Worldwide.	NO_COMP	False	
OBJECT_A 1 ½ - OBJECT_B 3 ½.	NO_COMP	False	
accessories on Amazon OBJECT_A and OBJECT_B.	NO_COMP	False	
Includes a 2-prong OBJECT_A to 2-prong OBJECT_B adapter.	NO_COMP	False	
Asia, OBJECT_A and OBJECT_B.	NO_COMP	False	
OBJECT_A can learn a lot from the OBJECT_B.	NO_COMP	False	
Thailand, Indonesia, Nepal,OBJECT_A, ,Japan, OBJECT_B etc.	NO_COMP	False	
Do they still manufacture Hugo Men in the OBJECT_A/OBJECT_B?	NO_COMP	False	
I have booked in the OBJECT_A and also OBJECT_B.	NO_COMP	False	
Looking for postdoc OBJECT_A/OBJECT_B/australia.	NO_COMP	False	
Since the BRIC group has done a little better than most, it follows that the OBJECT_A, OBJECT_B, and Japan have lost ground.	UNCLEAR	True	
The OBJECT_A was 8 or 10 times worse than OBJECT_B, any warnings there then?	WORSE	True	
They were rarely, if ever, "adventurous explorers" who left OBJECT_A because they sought adventure, like people in the OBJECT_B like to believe.	NO_COMP	False	
far from OBJECT_A and OBJECT_B will have better luck too.	NO_COMP	False	
[4] More better and affordable DualSIM phones (again NOT for OBJECT_A) for Asia, OBJECT_B and Brazil	NO_COMP	False	
They're probably easy to use in OBJECT_A, but you have to jump through legal hoops in the OBJECT_B because of the FAA.	NO_COMP	False	
Or, how many are dying in the world because of famine, caused many times by the agriculture subsidies in OBJECT_A and OBJECT_B, or lack of world distribution policy, just to mention two points.	NO_COMP	False	
Lybia faced substantual economic and trade sanctions from the OBJECT_A and OBJECT_B including on oil sales, just making the situation worse.	NO_COMP	False	
There is on the one hand the American OBJECT_A, something like Canada, an ally and trading partner of the OBJECT_B, which however only remains in perpetual dependence because of dissimilar power relations...	NO_COMP	False	
the tin cans you call cars in OBJECT_A are not available in the OBJECT_B because they don't meet the crash test requirements and they don't meet the emission requirements	NO_COMP	False	
registered went to take the survey and because I am in OBJECT_A and registered in OBJECT_B it said i couldnt participate .	NO_COMP	False	
Commercial borrowings have come to a virtual halt already in the OBJECT_A and the situation does not look much better in most parts of OBJECT_B.	NO_COMP	False	
With basketball we'll have to compete with OBJECT_A, OBJECT_B and Asian leagues, so the league will be worse then CFL	NO_COMP	False	
OBJECT_A has starved itself, spending-wise for 30-40 years, even worse than the OBJECT_B, and has erected the most insane monetary institutions in the history of humanity.	WORSE	True	
You must not be a long-time reader here, because one of our recurring themes is that the fate of OBJECT_A is crucial to that of the OBJECT_B.	NO_COMP	False	
I ask because i'm in OBJECT_A and have 'E' and I noticed that someone in the OBJECT_B mentioned their firmware revvision in a post and they had a 'U'.	NO_COMP	False	
OBJECT_A is in big trouble because they waited too long for AUSTERITY, lets not make the same mistake in the OBJECT_B!	NO_COMP	False	
have  a good reputation in China , OBJECT_A and OBJECT_B with superior quality and competitive price.	NO_COMP	False	
and i know they really do work, because these things are used even in OBJECT_A and OBJECT_B to treat dark spots from scars.	NO_COMP	False	
DRTX is interesting because it will be filling both in the OBJECT_A and OBJECT_B for approval later this year and is trading near its 52 week low.	NO_COMP	False	
His racing triumphs in OBJECT_A, Africa and the OBJECT_B made him a public idol - not least because of his swashbuckling driving style.	NO_COMP	False	
The good ol' OBJECT_A exists largely because people in OBJECT_B fled when things got bad for them.	NO_COMP	False	
Just about every investment fund is buying or will buy or invest in Asia over the next 3 to 5 years because there is poor returns and high risks in OBJECT_A and OBJECT_B.	UNCLEAR	True	
The process of formation of those new cults and sects was especially active in OBJECT_A, because, originally, traditional Christianity had less influence there than in OBJECT_B.	UNCLEAR	True	
I want to know because my hauls, be it from the OBJECT_A or OBJECT_B, always take more than 1 month to arrive and I've been wondering if it is that slow in other places too.	NO_COMP	False	
The Latino markets are stable and growing ...while OBJECT_A is in crisis and OBJECT_B had undergone worse in 2008-9.	NO_COMP	False	
In OBJECT_A, but also in countries like Japan and OBJECT_B, they got a lot of attention because of their energetic, heavy raw music on record and on stage.	NO_COMP	False	
OBJECT_A seems a better bet than OBJECT_B.	BETTER	True	
I do not for a moment believe that the "real" IT engineers in the OBJECT_A or OBJECT_B could have lost jobs because of outsourcing.	NO_COMP	False	
Hand & glove w/OBJECT_A declining imports, and if you think their exports are down to us, exports for them to OBJECT_B are much worse.	BETTER	True	
he is ready made for Russia or the middle east negotiators who love nothing better than to lie and mislead the OBJECT_A and OBJECT_B on the other hand they know nothing of gov.	NO_COMP	False	
And Barça players play as a team, because in OBJECT_A, basketball is still a sport (I'm afraid basketball in OBJECT_B is just a show).	NO_COMP	False	
OBJECT_A has almost double the amount of the population, its not as big as the OBJECT_B but it feeds way more people, tough the food quality is light-years better.	BETTER	True	
I don't know how Campagnolo Veloce is priced in the OBJECT_A, but it's even better price-performance ratio than 105 here in OBJECT_B.	WORSE	True	
Agree to the coments given above but still we are much better of than OBJECT_A or OBJECT_B of the world .	NO_COMP	False	
rail is king is japan and OBJECT_A because these places are so much more dense population wise than the OBJECT_B.	UNCLEAR	True	
2nd, we have the highest rates because the market's potential is lower than in OBJECT_A and the OBJECT_B.	NO_COMP	False	
Safety is hard to compete on these days because global regulations mean airlines that fly into well-policed spots like the OBJECT_A or OBJECT_B are forced to get it right or they're not allowed in.	NO_COMP	False	
This has been achieved because of what has happened in OBJECT_A and Japan (and soon OBJECT_B on a large scale).	NO_COMP	False	
I tend to think that we in OBJECT_A would be better off if they decided for joining the OBJECT_B .	NO_COMP	False	
I can appreciate it because that's exactly how we always travel, either from Australia to OBJECT_A /OBJECT_B or on the way home.	NO_COMP	False	
Well then, relocate to OBJECT_A and let us know how much better the healthcare system is compared to the OBJECT_B.	NO_COMP	False	
They purchased a quantity of lens from Nikon in OBJECT_A at a better price than they could get from Nikon OBJECT_B.	BETTER	True	
We suspect it because most Debian come from OBJECT_A and OBJECT_B, but that's all.	NO_COMP	False	
The Raja because of various situations and circumstances has met many Western individuals and scholars from OBJECT_A, the OBJECT_B, Australia and the like.	NO_COMP	False	
Sikhs came either as direct passengers mainly on ships via OBJECT_A or because they were not allowed to disembark at the OBJECT_B ports.	NO_COMP	False	
Conditions in those Third World prisons are notoriously worse than in the zealots' mansions, and in the comparatively posh modern jails and prisons found in most of the OBJECT_A and OBJECT_B.	UNCLEAR	True	
again bruno, reichardo is a little soft on the concept that OBJECT_A could do anyything better or more efficient than the OBJECT_B...	NO_COMP	False	
IOM in Australia has a forum though the ARYA but hardly anyone visits this site is ggod because you get people from all over OBJECT_A, you guys over there in OBJECT_B and skippers from Asia, Aus and NZ.	NO_COMP	False	
Presently, it makes no sence for a cruiserweight to move out to the OBJECT_A because the best boxers of this division are fighting in OBJECT_B.	WORSE	True	
I use Navtext for weather, which is unusual in the OBJECT_A because weather information is free on the VHF and Web, but common in OBJECT_B, where it is not free.	UNCLEAR	True	
And even though T-Mobile in OBJECT_A offers the iPhone, T-Mobile OBJECT_B isn't quite an option either, mostly because its 3G technology is incompatible.	NO_COMP	False	
OBJECT_A seems in better shape than the OBJECT_B.	BETTER	True	
Remember that you tell people it's stupid to talk about slashing the use of fossil fuels because it's just going to be done by India and China if the OBJECT_A and OBJECT_B decide to cut back.	NO_COMP	False	
I was thinking maybe OBJECT_A or Asia for the next set of photo walks... I'm not sure because we still missed a lot of cities in the OBJECT_B I wanted to visit, especially in the Pacific Northwest.	NO_COMP	False	
The OBJECT_A is far more better than OBJECT_B.	BETTER	True	
I just wanted to say I'm in America/OBJECT_A and even though the servers are in OBJECT_B the connection is amazing, very little late, uptime is great, support is amazing, better than I even thought.	NO_COMP	False	
It is a better world if OBJECT_A/Canada/OBJECT_B can follow a more well-rounded model.	NO_COMP	False	
So as a market OBJECT_A is more important than the OBJECT_B because SONY has a bigger market and it should get more attention .	BETTER	True	
Due to this wide and popular introduction of 'Eureka' in OBJECT_A, it became much better known there than in the OBJECT_B.	BETTER	True	
OBJECT_A and the OBJECT_B have many things in common, one of which noted currently is the massive debt crisis both are experiencing because of politicians who fail to learn from history.	NO_COMP	False	
The Indian nation has the ability to sort out its mess up better than OBJECT_A and OBJECT_B is sorting out theirs and do not need to be preached to...or patronised.	NO_COMP	False	
During there career, Charsima ended up releasing two albums both sold better in OBJECT_A than they did in the OBJECT_B.	BETTER	True	
There's a lot of lazy stereotyping in the media's treatment of science politics in the OBJECT_A and OBJECT_B, but we ought to try and do better.	NO_COMP	False	
In a few words, if anti-science PR campaigns are successful in OBJECT_A but not in OBJECT_B it's because (significant part of) the public is ready to accept them.	NO_COMP	False	
Only checked out Leona because of you, then ordered the CD from OBJECT_A prior to OBJECT_B release because I liked what I heard.	NO_COMP	False	
Turns out that this lady Hite was totally destroyed in the OBJECT_A, she had to move to OBJECT_B because she publicized a report on Sexuality.	NO_COMP	False	
It frankly doesn't matter what Iran does at the international stage because OBJECT_A - and by extension, Western OBJECT_B - sees Iran as untrustworthy.	NO_COMP	False	
Well-wishers from England will continue to chivy the OBJECT_A because they see from their own experience, of England in OBJECT_B, what happens when common law competes with ROW civil law.	NO_COMP	False	
Although SDT is often used in OBJECT_A to initiate a rapid response, it is less utilized within the OBJECT_B, in part, because it has a short duration when administered alone.	NO_COMP	False	
OBJECT_A fell down under superior aliens tehnical power and now the target is OBJECT_B.	NO_COMP	False	
SCEE need to examine why people need to set up OBJECT_A and japan accounts- its because we in OBJECT_B get treated in sucha third rate that they think is acceptable.	NO_COMP	False	
The Verdict: So which is better overall, the OBJECT_A or Eastern OBJECT_B?	NO_COMP	False	
People can be dull, workers in OBJECT_A and OBJECT_B are losing their jobs because of these salary increments being forced on companies by Governments.	NO_COMP	False	
American imperialism did not want Hitler to succeed because that would have created a powerful rival to the OBJECT_A in OBJECT_B.	NO_COMP	False	
- OBJECT_A: DB & OBJECT_B: OF	NO_COMP	False	
He played sports, especially OBJECT_A and OBJECT_B.	NO_COMP	False	
The boys are in OBJECT_A and OBJECT_B.	NO_COMP	False	
Love OBJECT_A and OBJECT_B?	NO_COMP	False	
Love to watch OBJECT_A , OBJECT_B , basketball , & boxing.	NO_COMP	False	
Sports cards - OBJECT_A,OBJECT_B, basketball,hockey & racing.	NO_COMP	False	
I love OBJECT_A, OBJECT_B, Golf and Fishing.	NO_COMP	False	
Passionate about OBJECT_A, OBJECT_B, basketball, and hockey.	NO_COMP	False	
OBJECT_A, OBJECT_B, basketball, MMA.	NO_COMP	False	
He used to play OBJECT_A and OBJECT_B.	NO_COMP	False	
Life!! Sports: OBJECT_A, swimming, OBJECT_B and tennis.	NO_COMP	False	
sports-OBJECT_A, OBJECT_B	NO_COMP	False	
It's not OBJECT_A or OBJECT_B.	NO_COMP	False	
He played OBJECT_A and OBJECT_B, at least.	NO_COMP	False	
They could talk OBJECT_A and OBJECT_B.	NO_COMP	False	
We used OBJECT_A, basketball, OBJECT_B cards.	NO_COMP	False	
And occasionally OBJECT_A or American OBJECT_B.	NO_COMP	False	
He was into OBJECT_A, basketball and OBJECT_B.	NO_COMP	False	
Doesn't compare to OBJECT_A and even OBJECT_B.	NO_COMP	False	
Joe loved OBJECT_A; Jason loved OBJECT_B.	NO_COMP	False	
night OBJECT_A B/C of freakin' OBJECT_B.	NO_COMP	False	
One OBJECT_A, one OBJECT_B.	NO_COMP	False	
Nathan enjoys & participates in OBJECT_A & OBJECT_B.	NO_COMP	False	
I love OBJECT_A and college OBJECT_B.	NO_COMP	False	
OBJECT_A/basketball/OBJECT_B (U-M 1924-28)	NO_COMP	False	
I went up there because of the condition of the OBJECT_A program and that they had a good OBJECT_B program as well.	NO_COMP	False	
And -- that's why it doesn't matter to sports fans as much based -- OBJECT_A fans as much as it does the OBJECT_B fans because.	NO_COMP	False	
We've been blessed because we have a new OBJECT_A park (Coors Field) and OBJECT_B stadium (Invesco Field).	NO_COMP	False	
The OBJECT_A facilities on campus are a lot better than they used to be and the OBJECT_B team is moving in the right direction.	NO_COMP	False	
So, for the record, here are ten reasons why OBJECT_A is better than OBJECT_B.	BETTER	True	
I felt I had a better chance to be a OBJECT_A player than a OBJECT_B player, said Coughlin.	BETTER	True	
Using your logic, you hate OBJECT_A because you defend OBJECT_B.	NO_COMP	False	
In college, Lou Gehrig couldn't play OBJECT_A at first because he had already played professionally so he joined the OBJECT_B team instead.	NO_COMP	False	
Part of the field condition problem is because of the OBJECT_A practice field being smaller after the reconstruction of the OBJECT_B and softball fields.	NO_COMP	False	
In OBJECT_A or OBJECT_B or hockey there are many more players involved, which allows the oppposing team to nuetralize the great players better.	NO_COMP	False	
Jackson never reached the Hall of Fame in either OBJECT_A or OBJECT_B, because injuries zapped away his longevity in both sports.	NO_COMP	False	
JFB, the reason why many high school basketball players, OBJECT_A players, etc. opt not to play OBJECT_B is because it's too dangerous.	NO_COMP	False	
Top 10 Reasons \OBJECT_A is Better Than OBJECT_B	BETTER	True	
I feel that OBJECT_A is much better live than on TV, in stark contrast to some other sports (such as American OBJECT_B, for example)	BETTER	True	
This kid had tremendous potential, and he hadn't even scratched the surface because he only played OBJECT_A when he wasn't on the OBJECT_B field."	NO_COMP	False	
This is why the better team wins any given basketball game with far greater frequency than it does in OBJECT_A, OBJECT_B or hockey.	NO_COMP	False	
The rules in OBJECT_A are a little different so them operating in a blindly optimistic fashion made it worse than it would have in OBJECT_B.	NO_COMP	False	
Don't get too distracted with fantasy OBJECT_A that you let your fellow fantasy OBJECT_B owners out-manage you down the stretch, costing you playoff seeding, or even worse, a playoff spot.	NO_COMP	False	
(This does not exclude touch or flag OBJECT_A, which are not intrinsically violent, though still aesthetically and intellectually inferior to OBJECT_B.)	WORSE	True	
Why is golf better than OBJECT_A or OBJECT_B?	BETTER	True	
OBJECT_A, OBJECT_B, hockey or soccer, never let anyone tell you that you can't do something because ...	NO_COMP	False	
It's such a personal thing for me and my family - especially because my son plays OBJECT_A and OBJECT_B - to be here tonight, Trevino said.	NO_COMP	False	
I did not pay much attention as I would argue with him that OBJECT_A was better than OBJECT_B.	BETTER	True	
Why I think it is dying is because there is no real market for the game/sport like OBJECT_A or OBJECT_B golf etc.	NO_COMP	False	
The only FWB you better be talking about is your favorite sports: OBJECT_A, Wrestling, Basketball/OBJECT_B .	NO_COMP	False	
As a sports fan, I pretty much define best by how high the competitiveness level is, the higher the better, at least in OBJECT_A, OBJECT_B, and tennis.	NO_COMP	False	
There is no real OBJECT_A equivalent to the OBJECT_B tailgate because there never needed to be one.	NO_COMP	False	
The design may be suitable for team sports such as OBJECT_A, OBJECT_B, and basketball, because the squads compete weekly and therefore have more data for analysis.	NO_COMP	False	
Touting "Hydrating Gel Reservoir," the new ads used OBJECT_A and OBJECT_B themes to say men prefer the Schick Hydro 5 over Gillette Fusion ProGlide at a better price.	NO_COMP	False	
I love OBJECT_A because it's a different way to compete other than physically like in OBJECT_B or basketball.	UNCLEAR	True	
Sometimes I feel like I would be a better American if I could just give two hoots about OBJECT_A and OBJECT_B.	NO_COMP	False	
Is like putting OBJECT_A players on a OBJECT_B field to play a game they cannot because the playing feild is not set up for it.	NO_COMP	False	
Making OBJECT_A have an 18 game season makes better sense than OBJECT_B anyway.	BETTER	True	
He decided to play OBJECT_A when he could have made a lot more money at OBJECT_B because he loved the game.	UNCLEAR	True	
I actually like OBJECT_A better than OBJECT_B, which believe it or not is my least favorite sport to watch.	BETTER	True	
What OBJECT_A and OBJECT_B do have is a long tradition of popularity, that however, does not mean they are better.	NO_COMP	False	
The Cyclones are basically Missouri with worse OBJECT_A and no OBJECT_B, and that overall strength gets ISU the #10 spot.	NO_COMP	False	
Folks in TX like high school & college OBJECT_A better than OBJECT_B.	BETTER	True	
What I tell all of them is, you'd better understand that OBJECT_A is just as important to him as OBJECT_B.	NO_COMP	False	
Im pretty certain that OBJECT_A and OBJECT_B are more accepted because they are more appealing to a much larger percentage of the population.	NO_COMP	False	
I also think the mainstream coverage of OBJECT_A is better than OBJECT_B, in terms of actually talking about every team.	BETTER	True	
Unlike soccer, OBJECT_A and OBJECT_B, basketball uniforms are limited, from a fashion perspective, because they are sleeveless.	NO_COMP	False	
Though the beautiful game may not interest us as much as OBJECT_A or OBJECT_B, there's no shame in loving it because it belongs to our country.	NO_COMP	False	
San Antonio is a possibility because they are dangling money for new stadiums in hope of getting a OBJECT_A and or OBJECT_B team.	NO_COMP	False	
Perhaps OBJECT_A really does have a better claim to be a "pastime" in the sense of a pleasant leisure hobby or pursuit, OBJECT_B is something more.	BETTER	True	
Why OBJECT_A is better than OBJECT_B	BETTER	True	
There is a reason why college OBJECT_A is inferior to its OBJECT_B and basketball counterparts and this is it.	WORSE	True	
Now, just because I'm getting excited for OBJECT_A doesn't mean I'm giving up on OBJECT_B for the year.	NO_COMP	False	
Imagine your children relentlessly bullied at school, at church, at soccer/OBJECT_A/OBJECT_B because they're yours.	NO_COMP	False	
He plays OBJECT_A, basketball, OBJECT_B, and will definitely be in track because, as he says it himself, he's fast.	NO_COMP	False	
The only reason I love Fantasy OBJECT_A or OBJECT_B is because it means D.W. comes into town and I get to see these guys.	NO_COMP	False	
I personally quit watching OBJECT_A and OBJECT_B, my favorite, 20 years ago because of the cheating and records broken by deceitful players using steroids.	NO_COMP	False	
Hampton revealed that he decided to play OBJECT_A instead of OBJECT_B because he was "Craig Biggio sized."	NO_COMP	False	
I think OBJECT_A and OBJECT_B work better on television than opera because they use technology.	UNCLEAR	True	
I'm not sure if it's better now, but I use ESPN for basketball and OBJECT_A updates so it seems like they should have a good OBJECT_B update.	NO_COMP	False	
A lot of these athletes in American professional sports have kinda let us down in a lot of the institutions, for better or for worse, be it OBJECT_A, OBJECT_B, or basketball," he explains.	NO_COMP	False	
The stands that move for OBJECT_A could be made permanent and angled better for OBJECT_B sightlines.	NO_COMP	False	
I reckon Golf is probably a better reference point as it is a TV based individual sport without the big weekly stadium crowds of OBJECT_A or OBJECT_B etc..	NO_COMP	False	
The home field advantage was very evident because unlike OBJECT_A or basketball players, OBJECT_B players are not use to playing in this environment," he said.	NO_COMP	False	
Sanders was the flashy one who was better at OBJECT_A than OBJECT_B.	BETTER	True	
not worried if you OBJECT_A game early in the year because you know there's going to be a 100 more to watch but OBJECT_B every game count's	NO_COMP	False	
OBJECT_A: This sport is interesting, because on its face, it's a game that values a players' overall strength and athletic ability much more than OBJECT_B.	BETTER	True	
Um,yeah,and I will also give up basketball and OBJECT_A and OBJECT_B because I criticize losers.	NO_COMP	False	
RACING Because OBJECT_A, OBJECT_B, bowling and golf only require ONE BALL	NO_COMP	False	
OBJECT_A and OBJECT_B camps at the YMCA were canceled this summer because of a lack of interest.	NO_COMP	False	
I'll be happy to go to a game or two when he's not there because its OBJECT_A not OBJECT_B or basketball.	NO_COMP	False	
Think that would be a little worse than a OBJECT_A or OBJECT_B strike?	NO_COMP	False	
If you have OBJECT_A, hockey and OBJECT_B players, you will need spacious athletic lockers because their equipment can get quite bulky.	NO_COMP	False	
Just as batting average is better known but overrated in OBJECT_A, so too is completion percentage in OBJECT_B.	NO_COMP	False	
He said even though he loved playing the hot corner, this would be his last year to play OBJECT_A because he really wanted to concentrate on OBJECT_B.	NO_COMP	False	
Using steroids is cheating in OBJECT_A and OBJECT_B because drugs and other substances are banned.	NO_COMP	False	
There's no doubt that OBJECT_A is better than OBJECT_B.	BETTER	True	
Mostly the dearth of female athletic heroes is because our nationally televised sports are all male dominated: basketball, OBJECT_A, OBJECT_B.	NO_COMP	False	
I think that OBJECT_A has done a better job of tackling the issue from a PR perspective than OBJECT_B.	BETTER	True	
In the 1980s Vans took a turn for the worse, when the known skate company started to produce OBJECT_A and OBJECT_B sneakers.	NO_COMP	False	
Selecting OBJECT_A, OBJECT_B or pork?	NO_COMP	False	
With OBJECT_A, Pork Or OBJECT_B.	NO_COMP	False	
More General Tso's OBJECT_A and orange OBJECT_B.	NO_COMP	False	
5 cups OBJECT_A or OBJECT_B broth	NO_COMP	False	
Grilled OBJECT_A Or OBJECT_B Enchiladas	NO_COMP	False	
excellent OBJECT_A, OBJECT_B, cheese, vacio, picania, lamb.	NO_COMP	False	
They have OBJECT_A, OBJECT_B, cheese, and corn.	NO_COMP	False	
I use their OBJECT_A and OBJECT_B base.	NO_COMP	False	
Lemon Grass OBJECT_A Or OBJECT_B	NO_COMP	False	
One OBJECT_A and one OBJECT_B.	NO_COMP	False	
Great on Pork, Seafood, OBJECT_A or OBJECT_B	NO_COMP	False	
Lean meats (OBJECT_A, pork, OBJECT_B, and turkey)	NO_COMP	False	
It also processes OBJECT_A and OBJECT_B.	NO_COMP	False	
7.99 OBJECT_A fajita 8.99 OBJECT_B fajita 10.99	NO_COMP	False	
OBJECT_A, OBJECT_B, or fish?	NO_COMP	False	
Hamburgers made with OBJECT_A, OBJECT_B or turkey	NO_COMP	False	
Animal Proteins - OBJECT_A, OBJECT_B,Egg, Lamb, Pork.	NO_COMP	False	
Some ground OBJECT_A or OBJECT_B.	NO_COMP	False	
...SHRED OBJECT_A, PORK, OBJECT_B WITH EASE!	NO_COMP	False	
Perfect  for OBJECT_A, OBJECT_B, or seafood kabobs.	NO_COMP	False	
8.95 OBJECT_A, OBJECT_B, Pork.	NO_COMP	False	
meat (OBJECT_A, OBJECT_B, pork, turkey)	NO_COMP	False	
OBJECT_A or Shredded OBJECT_B	NO_COMP	False	
Philly OBJECT_A -or- OBJECT_B	NO_COMP	False	
OBJECT_A stock or OBJECT_B stock would work.	NO_COMP	False	
GIVE IT A REST: OBJECT_A, steak, OBJECT_B -- almost anything you grill-will taste better if you let it stand on the cutting board for a few minutes before serving.	NO_COMP	False	
That is because it takes close to 15 pounds of grain to make 1 pound of OBJECT_A meat and about 5 pounds of grain to create 1 pound of OBJECT_B.	NO_COMP	False	
We did notice that switching to no wheat, OBJECT_A or OBJECT_B protein she did a LOT better.	NO_COMP	False	
We definitely are able to move more lamb because we have OBJECT_A and OBJECT_B, said Stone.	NO_COMP	False	
Vitamin B12 from foods appear to have different absorption rates with better absorption from OBJECT_A and OBJECT_B as compared to eggs.	UNCLEAR	True	
But this issue was right up my alley: pan-seared OBJECT_A breasts, everyday OBJECT_B stroganoff, better stir-fried broccoli.	NO_COMP	False	
Today I'm addressing protein - OBJECT_A, pork, OBJECT_B, fish - because protein is often the most expensive component of a meal.	NO_COMP	False	
For example, he likes to use local OBJECT_A or OBJECT_B fat in place of olive oil because it is less expensive and can be produced at home, he said.	NO_COMP	False	
It's not that I like pork better than say OBJECT_A or OBJECT_B, but as far as industrial/conventional meat goes, it's probably the worst of the three.	NO_COMP	False	
The son I raised would never have asked to have OBJECT_A instead of taco meat, because that son would have been considerate of the fact that his mother slaved over that ground OBJECT_B.	NO_COMP	False	
When I made that my husband thought it was the weirdest thing to do, because it was OBJECT_A flavor with ground OBJECT_B.	NO_COMP	False	
I had recently enjoyed a maple and mustard glazed OBJECT_A and I was thinking that the corned OBJECT_B would be even better with a sweet and tangy honey mustard glaze.	WORSE	True	
I like it more than Baja Fresh because in addition to steak and OBJECT_A, they have ground OBJECT_B.	NO_COMP	False	
DH and I might like to try OBJECT_A or OBJECT_B broth for our sauce next time, however, because it might make it a little thicker and give it that meatier flavor we carnivores were looking for.	NO_COMP	False	
If you shy away from saltimbocca because you don't eat veal, then do yourself a favor and try this twist on the classic Roman dish, which uses OBJECT_A in place of OBJECT_B.	NO_COMP	False	
The OBJECT_A in the hamburger was hideous, but I ate it anyway because I was so hungry, and I knew I had the delicious taste of old deep-fried OBJECT_B to chase it down.	WORSE	True	
We order this because the OBJECT_A and OBJECT_B are very tender and we love the peanut sauce they serve with the barbecued meat.	NO_COMP	False	
Not the most nutritious of foods; in retrospect, I'd probably would have been no worse off if I'd stuck with water and homemade OBJECT_A and OBJECT_B broths, especially since I'd been told to avoid dairy.	NO_COMP	False	
I'll have to try your OBJECT_A version, it sounds even better than with OBJECT_B.	BETTER	True	
I added bell pepper and used ground OBJECT_A in place of OBJECT_B, just because that's what I had.	NO_COMP	False	
Rosemary is a favorite herb of many cooks because it enhances the flavor of OBJECT_A, OBJECT_B, fish and vegetable dishes.	NO_COMP	False	
A new study runs the numbers on the environmental impact of mealworm farming, and no surprise, the numbers are much better than those for OBJECT_A, OBJECT_B or pork farming.	UNCLEAR	True	
I made them with OBJECT_A meat, because now days many people are not eating OBJECT_B.	NO_COMP	False	
This year I'm going to make them with half ground pork and half ground OBJECT_A because I have a hard time digesting OBJECT_B and therefore almost never eat it.	BETTER	True	
No way in hell can I (currently) afford the OBJECT_A and OBJECT_B that is better for me.	NO_COMP	False	
I made stuffed pepper soup out of OBJECT_A stock, tomato sauce, ground OBJECT_B and chopped peppers (sometimes rice, sometimes not, liked it better without).	NO_COMP	False	
Of course it would be better if you added some meat like OBJECT_A or pork or OBJECT_B and some vegetables like onions, carrots and potatoes.	NO_COMP	False	
It was amazing and better than OBJECT_A or OBJECT_B!	NO_COMP	False	
I give this one 7.5/10 , the half-point deduction due to the OBJECT_A being better than the OBJECT_B.	BETTER	True	
Pedro Alvarez, a Cuban trade official, acknowledged a shortage of OBJECT_A but said there is no hunger in Cuba because citizens receive government-subsidized food, including bread, rice and OBJECT_B.	NO_COMP	False	
Pho 24 also has a vegetarian option for pho, replacing OBJECT_A and OBJECT_B with a variety of mushrooms.Pho is different kind of segment with Kebab because Pho is a noodle.	NO_COMP	False	
And remember that we have all different types of meat shakes: ham shakes, turkey shakes, OBJECT_A shakes, meatball shakes, OBJECT_B shakes, and we even have fish shakes because of popular demand.	NO_COMP	False	what
The modern American diet is not so rich in PUFA because everyone is eating too much OBJECT_A and not enough OBJECT_B.	NO_COMP	False	
Plus, on average, the OBJECT_A entrees microwave better than OBJECT_B .	BETTER	True	
Nutritionally and environmentally superior to most plants, its seed is made of 35 percent protein - more than the protein content of both OBJECT_A and OBJECT_B.	NO_COMP	False	
Reading the labels of soups and sauces is also important, according to Paulson, because the ingredients may include OBJECT_A or OBJECT_B broth.	NO_COMP	False	
I no longer eat pork, I rarely eat OBJECT_A, and I don't like OBJECT_B now because my mother keeps four hens as pets.	NO_COMP	False	
Plus, one day they had a fight because he brought home OBJECT_A hot dogs when Leah wanted pork and OBJECT_B.	NO_COMP	False	
But second best option is Better Than Bouillon - a jar of concentrated bouillon paste to which you add boiling water to make OBJECT_A, OBJECT_B, or vegetable broth.	NO_COMP	False	
They are famous because of their succulent OBJECT_A, mutton and OBJECT_B satay with their secret marinate and their homemade peanut sauce compliments the satay so well.	NO_COMP	False	
The second is because the OBJECT_A and OBJECT_B are both feedlot-raised, whereas the pork is pastured when weather allows or raised in large barns with lots of space for foraging when the weather is bad.	NO_COMP	False	
The Maharaja Mac, sold in India, is not included in the Big Mac Index because it has a OBJECT_A patty instead of OBJECT_B.	NO_COMP	False	
Hope you feel better soon Heather! ps- best sources of iron per serving are 1.OBJECT_A liver 2.OBJECT_B 3.clams 4.dark meat turkey.	NO_COMP	False	
We eat a lot of ground OBJECT_A and OBJECT_B, because it's cheaper than most meats.	UNCLEAR	True	
I'd love to try the OBJECT_A curry or OBJECT_B dish, but I'm not eating the meat because of the fear of contamination with doping controls .	NO_COMP	False	
I am a single mom and really strapped for cash so a lot of times I am stuck buying a lot of ground OBJECT_A or OBJECT_B because they are the cheapest for meals.	NO_COMP	False	
The pork tenderloin is great in a stir-fry type dish because it's so moist and tender - and it tastes somehow "fancier" than the usual OBJECT_A or OBJECT_B.	UNCLEAR	True	
Having tried it for the first time last week I have to say that it is much better suited to OBJECT_A than pork or OBJECT_B for me.	NO_COMP	False	
I should have known better after watching the commercial for Boston Market where they tout eating OBJECT_A instead of OBJECT_B.	NO_COMP	False	
Your noodle comes with choice of protein; the OBJECT_A was a bit tough, but seafood, and OBJECT_B, were more tender and better to my taste.	WORSE	True	
The only reason I ever cook OBJECT_A or OBJECT_B is because I cave to my wife and son's demands.	NO_COMP	False	
kidneys, because we like them, and used double OBJECT_A boullion since we were out of OBJECT_B.	NO_COMP	False	
Ideal for a large turkey, roast OBJECT_A or OBJECT_B, the durable hard anodized aluminum features a superior nonstick for super easy cleaning.	NO_COMP	False	
So as a surprise I was making Steak Scampi for dinner for my carnivorous better half, (I don't eat OBJECT_A, so I had a OBJECT_B burger), this was why I bought the crab meat.	NO_COMP	False	
Of course, the hormones and antibiotics injected into OBJECT_A and OBJECT_B do not promote better consumer health, to say the least.	NO_COMP	False	
It would be better if water wasnot the first ingredient, & the meat was a named meat, such as OBJECT_A, OBJECT_B, or fish.	NO_COMP	False	
Many folks came because of the Cowboy Poetry and of course the barbecued roast OBJECT_A and OBJECT_B dinner.	NO_COMP	False	
Print a coupon for a free Taco Bell Fresco Taco ($1.89 value) in your choice of OBJECT_A, steak, or OBJECT_B because these coupons have been reset!	NO_COMP	False	
Sawyer definitely does better on a OBJECT_A/rabbit rotation, but boy howdy does he love his OBJECT_B and turkey!	BETTER	True	
While this may better mimic the eating habits of a dog's ancestral wolves, the cost to make dog food using fresh OBJECT_A and OBJECT_B more than doubles that of the competition.	NO_COMP	False	
How OBJECT_A, OBJECT_B and swine slaughter houses run is much worse than what anyone can say about this show.	NO_COMP	False	
I like these tablets because they're not flavored with OBJECT_A, OBJECT_B, or pork or contain additives and fillers.	NO_COMP	False	
Right now we are seeing consumers who might reach for the ground OBJECT_A chose the OBJECT_B instead, because it's a cheaper protein relatively speaking, Smith said.	NO_COMP	False	
I believe OBJECT_A tastes better than OBJECT_B liver.	BETTER	True	
OBJECT_A volumes were down about 2% from last year, pork was down 17%, and OBJECT_B was down 3%, but pricing was significantly better.	NO_COMP	False	
I realize that the point of using the OBJECT_A is to reduce the fat content, but I'd rather add a little fat and have the better texture that you get from ground OBJECT_B.	WORSE	True	
I am the wife of a really really picky eater who doesn't like OBJECT_A because the skin is too tough, who would only eat turkey and OBJECT_B if it is fried and who hates fish.	NO_COMP	False	
MuscleGel Shots: Because my body does not respond well to things like OBJECT_A, turkey, and OBJECT_B anymore, these are my predominate source of protein.	NO_COMP	False	
If the price of OBJECT_A fell and the quantity of OBJECT_B fell the answer will be positive, because two negatives make a positive, so any items with a positive cross elasticity are substitutes.	NO_COMP	False	
I think KFC is more popular in the rest of the world because a lot of other cultures don't eat OBJECT_A, but they do eat OBJECT_B!	NO_COMP	False	
WASHINGTON, D.C. - A recall has been issued for nearly 23,000 pounds of OBJECT_A, ham and OBJECT_B products because of a potential Listeria monocytogenes contamination.	NO_COMP	False	
I imagine we'll still buy steak from time to time, but I was starting to feel like we were relying too much on ground OBJECT_A and OBJECT_B breast because they are easy.	NO_COMP	False	
onion powder 1 T. granulated OBJECT_A, OBJECT_B, tomato, or vegetable bouillon (I like to use Better than Bouillon Organic Paste)	NO_COMP	False	
I usually mix it with boiled OBJECT_A and veggies because they don't do well with OBJECT_B.	NO_COMP	False	
What better way to celebrate the holiday than with a dish of tasty skewers of OBJECT_A and OBJECT_B called "The Mexican Flag"?	NO_COMP	False	